vehicle_make,model,year_manu,total,pass,pass%,fail,fail%,incomplete,incomplete%
ABARTH,595,2013,1,1,100.0,0,0.0,0,0.0
AC,OTHER,2006,1,0,0.0,1,100.0,0,0.0
ALFA ROMEO,145,1998,2,1,50.0,1,50.0,0,0.0
ALFA ROMEO,145,1999,2,1,50.0,1,50.0,0,0.0
ALFA ROMEO,145,2000,2,0,0.0,2,100.0,0,0.0
ALFA ROMEO,146,1997,2,0,0.0,2,100.0,0,0.0
ALFA ROMEO,146,1998,3,0,0.0,3,100.0,0,0.0
ALFA ROMEO,146,1999,1,0,0.0,1,100.0,0,0.0
ALFA ROMEO,146,2000,4,1,25.0,3,75.0,0,0.0
ALFA ROMEO,147,2001,10,4,40.0,6,60.0,0,0.0
ALFA ROMEO,147,2002,33,10,30.3,23,69.7,0,0.0
ALFA ROMEO,147,2003,35,10,28.6,25,71.4,0,0.0
ALFA ROMEO,147,2004,32,11,34.4,21,65.6,0,0.0
ALFA ROMEO,147,2005,65,26,40.0,39,60.0,0,0.0
ALFA ROMEO,147,2006,76,19,25.0,57,75.0,0,0.0
ALFA ROMEO,147,2007,69,31,44.9,38,55.1,0,0.0
ALFA ROMEO,147,2008,49,17,34.7,32,65.3,0,0.0
ALFA ROMEO,147,2010,17,10,58.8,7,41.2,0,0.0
ALFA ROMEO,155,1994,3,0,0.0,3,100.0,0,0.0
ALFA ROMEO,155,1995,1,0,0.0,1,100.0,0,0.0
ALFA ROMEO,155,1997,4,2,50.0,2,50.0,0,0.0
ALFA ROMEO,156,1998,9,1,11.1,8,88.9,0,0.0
ALFA ROMEO,156,1999,13,3,23.1,10,76.9,0,0.0
ALFA ROMEO,156,2000,29,12,41.4,17,58.6,0,0.0
ALFA ROMEO,156,2001,45,16,35.6,29,64.4,0,0.0
ALFA ROMEO,156,2002,42,9,21.4,33,78.6,0,0.0
ALFA ROMEO,156,2003,86,22,25.6,64,74.4,0,0.0
ALFA ROMEO,156,2004,136,36,26.5,100,73.5,0,0.0
ALFA ROMEO,156,2005,82,23,28.0,59,72.0,0,0.0
ALFA ROMEO,156,2006,8,1,12.5,7,87.5,0,0.0
ALFA ROMEO,156,2007,1,0,0.0,1,100.0,0,0.0
ALFA ROMEO,159,2006,136,44,32.4,92,67.6,0,0.0
ALFA ROMEO,159,2007,198,87,43.9,111,56.1,0,0.0
ALFA ROMEO,159,2008,129,60,46.5,69,53.5,0,0.0
ALFA ROMEO,159,2009,40,14,35.0,26,65.0,0,0.0
ALFA ROMEO,159,2010,58,33,56.9,25,43.1,0,0.0
ALFA ROMEO,159,2011,23,12,52.2,11,47.8,0,0.0
ALFA ROMEO,159,2012,2,2,100.0,0,0.0,0,0.0
ALFA ROMEO,166,2001,1,1,100.0,0,0.0,0,0.0
ALFA ROMEO,166,2002,1,0,0.0,1,100.0,0,0.0
ALFA ROMEO,166,2004,5,0,0.0,5,100.0,0,0.0
ALFA ROMEO,166,2005,5,1,20.0,4,80.0,0,0.0
ALFA ROMEO,166,2006,2,0,0.0,2,100.0,0,0.0
ALFA ROMEO,BRERA,2006,13,5,38.5,8,61.5,0,0.0
ALFA ROMEO,BRERA,2007,21,12,57.1,9,42.9,0,0.0
ALFA ROMEO,BRERA,2008,10,5,50.0,5,50.0,0,0.0
ALFA ROMEO,BRERA,2009,1,1,100.0,0,0.0,0,0.0
ALFA ROMEO,BRERA,2010,3,1,33.3,2,66.7,0,0.0
ALFA ROMEO,BRERA 2.4 JTDM SV 200BHP,2007,1,1,100.0,0,0.0,0,0.0
ALFA ROMEO,GIULIETTA,2010,18,13,72.2,5,27.8,0,0.0
ALFA ROMEO,GIULIETTA,2011,16,12,75.0,4,25.0,0,0.0
ALFA ROMEO,GIULIETTA,2012,90,76,84.4,14,15.6,0,0.0
ALFA ROMEO,GIULIETTA,2013,1,1,100.0,0,0.0,0,0.0
ALFA ROMEO,GIULIETTA,2014,30,27,90.0,3,10.0,0,0.0
ALFA ROMEO,GIULIETTA,2015,5,4,80.0,1,20.0,0,0.0
ALFA ROMEO,GT,2004,29,5,17.2,24,82.8,0,0.0
ALFA ROMEO,GT,2005,97,38,39.2,59,60.8,0,0.0
ALFA ROMEO,GT,2006,77,28,36.4,49,63.6,0,0.0
ALFA ROMEO,GT,2007,67,20,29.9,47,70.1,0,0.0
ALFA ROMEO,GT,2008,43,17,39.5,26,60.5,0,0.0
ALFA ROMEO,GT,2009,3,1,33.3,2,66.7,0,0.0
ALFA ROMEO,GT,2010,11,5,45.5,6,54.5,0,0.0
ALFA ROMEO,GTV,1995,1,0,0.0,1,100.0,0,0.0
ALFA ROMEO,GTV,1996,1,0,0.0,1,100.0,0,0.0
ALFA ROMEO,GTV,1997,1,0,0.0,1,100.0,0,0.0
ALFA ROMEO,GTV,1999,4,1,25.0,3,75.0,0,0.0
ALFA ROMEO,GTV,2000,4,2,50.0,2,50.0,0,0.0
ALFA ROMEO,GTV,2001,2,0,0.0,2,100.0,0,0.0
ALFA ROMEO,MITO,2009,22,19,86.4,3,13.6,0,0.0
ALFA ROMEO,MITO,2010,36,16,44.4,20,55.6,0,0.0
ALFA ROMEO,MITO,2011,5,2,40.0,3,60.0,0,0.0
ALFA ROMEO,MITO,2012,5,3,60.0,2,40.0,0,0.0
ALFA ROMEO,MITO,2014,4,3,75.0,1,25.0,0,0.0
ALFA ROMEO,OTHER,1982,2,0,0.0,2,100.0,0,0.0
ALFA ROMEO,OTHER,1983,1,1,100.0,0,0.0,0,0.0
ALFA ROMEO,OTHER,1984,1,1,100.0,0,0.0,0,0.0
ALFA ROMEO,OTHER,1987,1,0,0.0,1,100.0,0,0.0
ALFA ROMEO,OTHER,1989,1,0,0.0,1,100.0,0,0.0
ALFA ROMEO,OTHER,1990,1,0,0.0,1,100.0,0,0.0
ALFA ROMEO,OTHER,1991,2,0,0.0,2,100.0,0,0.0
ALFA ROMEO,OTHER,1992,2,0,0.0,2,100.0,0,0.0
ALFA ROMEO,OTHER,1995,1,1,100.0,0,0.0,0,0.0
ALFA ROMEO,OTHER,1996,5,2,40.0,3,60.0,0,0.0
ALFA ROMEO,OTHER,1997,4,1,25.0,3,75.0,0,0.0
ALFA ROMEO,OTHER,1998,2,0,0.0,2,100.0,0,0.0
ALFA ROMEO,OTHER,1999,7,4,57.1,3,42.9,0,0.0
ALFA ROMEO,OTHER,2000,5,1,20.0,4,80.0,0,0.0
ALFA ROMEO,OTHER,2001,19,4,21.1,15,78.9,0,0.0
ALFA ROMEO,OTHER,2002,27,9,33.3,18,66.7,0,0.0
ALFA ROMEO,OTHER,2003,23,4,17.4,19,82.6,0,0.0
ALFA ROMEO,OTHER,2004,16,4,25.0,12,75.0,0,0.0
ALFA ROMEO,OTHER,2005,5,1,20.0,4,80.0,0,0.0
ALFA ROMEO,OTHER,2006,2,0,0.0,2,100.0,0,0.0
ALFA ROMEO,OTHER,2008,1,1,100.0,0,0.0,0,0.0
ALFA ROMEO,OTHER,2009,13,6,46.2,7,53.8,0,0.0
ALFA ROMEO,OTHER,2010,26,14,53.8,12,46.2,0,0.0
ALFA ROMEO,OTHER,2011,43,28,65.1,15,34.9,0,0.0
ALFA ROMEO,OTHER,2012,37,21,56.8,16,43.2,0,0.0
ALFA ROMEO,OTHER,2013,12,7,58.3,5,41.7,0,0.0
ALFA ROMEO,OTHER,2014,28,21,75.0,7,25.0,0,0.0
ALFA ROMEO,OTHER,2015,2,2,100.0,0,0.0,0,0.0
ALFA ROMEO,SPIDER,1984,4,0,0.0,4,100.0,0,0.0
ALFA ROMEO,SPIDER,1986,2,1,50.0,1,50.0,0,0.0
ALFA ROMEO,SPIDER,1988,1,0,0.0,1,100.0,0,0.0
ALFA ROMEO,SPIDER,1989,2,1,50.0,1,50.0,0,0.0
ALFA ROMEO,SPIDER,1990,3,2,66.7,1,33.3,0,0.0
ALFA ROMEO,SPIDER,1991,2,1,50.0,1,50.0,0,0.0
ALFA ROMEO,SPIDER,1992,1,0,0.0,1,100.0,0,0.0
ALFA ROMEO,SPIDER,1993,1,0,0.0,1,100.0,0,0.0
ALFA ROMEO,SPIDER,1996,3,1,33.3,2,66.7,0,0.0
ALFA ROMEO,SPIDER,1997,5,2,40.0,3,60.0,0,0.0
ALFA ROMEO,SPIDER,1998,11,4,36.4,7,63.6,0,0.0
ALFA ROMEO,SPIDER,1999,9,5,55.6,4,44.4,0,0.0
ALFA ROMEO,SPIDER,2000,8,4,50.0,4,50.0,0,0.0
ALFA ROMEO,SPIDER,2001,5,3,60.0,2,40.0,0,0.0
ALFA ROMEO,SPIDER,2002,2,1,50.0,1,50.0,0,0.0
ALFA ROMEO,SPIDER,2003,1,1,100.0,0,0.0,0,0.0
ALFA ROMEO,SPIDER,2007,1,0,0.0,1,100.0,0,0.0
ALFA ROMEO,SPIDER,2008,3,2,66.7,1,33.3,0,0.0
ASQUITH,OTHER,1997,2,0,0.0,2,100.0,0,0.0
ASTON MARTIN,DB9,2005,1,0,0.0,1,100.0,0,0.0
ASTON MARTIN,DB9,2010,1,1,100.0,0,0.0,0,0.0
ASTON MARTIN,DB9,2011,1,0,0.0,1,100.0,0,0.0
ASTON MARTIN,OTHER,1995,2,0,0.0,2,100.0,0,0.0
ASTON MARTIN,OTHER,1998,1,0,0.0,1,100.0,0,0.0
ASTON MARTIN,OTHER,1999,2,1,50.0,1,50.0,0,0.0
ASTON MARTIN,OTHER,2000,2,1,50.0,1,50.0,0,0.0
ASTON MARTIN,OTHER,2002,2,1,50.0,1,50.0,0,0.0
ASTON MARTIN,OTHER,2003,2,1,50.0,1,50.0,0,0.0
ASTON MARTIN,OTHER,2004,1,0,0.0,1,100.0,0,0.0
ASTON MARTIN,OTHER,2005,14,4,28.6,10,71.4,0,0.0
ASTON MARTIN,OTHER,2006,14,11,78.6,3,21.4,0,0.0
ASTON MARTIN,OTHER,2007,9,7,77.8,2,22.2,0,0.0
ASTON MARTIN,OTHER,2008,4,2,50.0,2,50.0,0,0.0
ASTON MARTIN,OTHER,2009,2,2,100.0,0,0.0,0,0.0
ASTON MARTIN,OTHER,2010,2,0,0.0,2,100.0,0,0.0
ASTON MARTIN,OTHER,2012,1,1,100.0,0,0.0,0,0.0
ASTON MARTIN,VANQUISH,2003,1,1,100.0,0,0.0,0,0.0
ASTON MARTIN,VANTAGE,2007,1,0,0.0,1,100.0,0,0.0
ASTON MARTIN,VANTAGE,2008,1,1,100.0,0,0.0,0,0.0
ASTON MARTIN,VANTAGE,2014,1,0,0.0,1,100.0,0,0.0
AUDI,100,1983,1,0,0.0,1,100.0,0,0.0
AUDI,100,1984,2,0,0.0,2,100.0,0,0.0
AUDI,100,1986,2,0,0.0,2,100.0,0,0.0
AUDI,100,1987,1,1,100.0,0,0.0,0,0.0
AUDI,100,1988,1,1,100.0,0,0.0,0,0.0
AUDI,100,1989,2,0,0.0,2,100.0,0,0.0
AUDI,100,1990,2,0,0.0,2,100.0,0,0.0
AUDI,100,1992,2,2,100.0,0,0.0,0,0.0
AUDI,100,1994,1,0,0.0,1,100.0,0,0.0
AUDI,200,1989,3,2,66.7,1,33.3,0,0.0
AUDI,200,1990,1,0,0.0,1,100.0,0,0.0
AUDI,80,1984,3,2,66.7,1,33.3,0,0.0
AUDI,80,1985,3,1,33.3,2,66.7,0,0.0
AUDI,80,1986,2,1,50.0,1,50.0,0,0.0
AUDI,80,1987,6,3,50.0,3,50.0,0,0.0
AUDI,80,1988,1,1,100.0,0,0.0,0,0.0
AUDI,80,1989,4,1,25.0,3,75.0,0,0.0
AUDI,80,1990,7,4,57.1,3,42.9,0,0.0
AUDI,80,1991,4,2,50.0,2,50.0,0,0.0
AUDI,80,1992,12,6,50.0,6,50.0,0,0.0
AUDI,80,1993,28,13,46.4,15,53.6,0,0.0
AUDI,80,1994,23,11,47.8,12,52.2,0,0.0
AUDI,80,1995,14,5,35.7,9,64.3,0,0.0
AUDI,80,1996,2,1,50.0,1,50.0,0,0.0
AUDI,90,1984,1,0,0.0,1,100.0,0,0.0
AUDI,90,1988,1,0,0.0,1,100.0,0,0.0
AUDI,A1,2010,18,11,61.1,7,38.9,0,0.0
AUDI,A1,2011,98,68,69.4,30,30.6,1,1.0
AUDI,A1,2012,337,241,71.5,96,28.5,0,0.0
AUDI,A1,2013,81,55,67.9,26,32.1,0,0.0
AUDI,A1,2014,355,256,72.1,99,27.9,1,0.3
AUDI,A1,2015,28,21,75.0,7,25.0,0,0.0
AUDI,A2,2000,10,5,50.0,5,50.0,0,0.0
AUDI,A2,2001,86,36,41.9,50,58.1,0,0.0
AUDI,A2,2002,66,24,36.4,42,63.6,0,0.0
AUDI,A2,2003,46,18,39.1,28,60.9,0,0.0
AUDI,A2,2004,44,13,29.5,31,70.5,0,0.0
AUDI,A2,2005,19,8,42.1,11,57.9,0,0.0
AUDI,A3,1996,1,0,0.0,1,100.0,0,0.0
AUDI,A3,1997,5,2,40.0,3,60.0,0,0.0
AUDI,A3,1998,14,3,21.4,11,78.6,0,0.0
AUDI,A3,1999,30,6,20.0,24,80.0,0,0.0
AUDI,A3,2000,54,15,27.8,39,72.2,0,0.0
AUDI,A3,2001,135,46,34.1,89,65.9,0,0.0
AUDI,A3,2002,263,85,32.3,178,67.7,0,0.0
AUDI,A3,2003,373,120,32.2,253,67.8,0,0.0
AUDI,A3,2004,978,345,35.3,633,64.7,0,0.0
AUDI,A3,2005,1563,568,36.3,995,63.7,2,0.1
AUDI,A3,2006,1522,645,42.4,877,57.6,0,0.0
AUDI,A3,2007,1409,706,50.1,703,49.9,1,0.1
AUDI,A3,2008,1334,670,50.2,664,49.8,0,0.0
AUDI,A3,2009,554,323,58.3,231,41.7,0,0.0
AUDI,A3,2010,1033,649,62.8,384,37.2,0,0.0
AUDI,A3,2011,279,163,58.4,116,41.6,0,0.0
AUDI,A3,2012,767,558,72.8,209,27.2,0,0.0
AUDI,A3,2013,329,243,73.9,86,26.1,0,0.0
AUDI,A3,2014,1548,1144,73.9,404,26.1,0,0.0
AUDI,A3,2015,120,98,81.7,22,18.3,0,0.0
AUDI,A3,2016,3,2,66.7,1,33.3,0,0.0
AUDI,A3 1.2,2010,2,2,100.0,0,0.0,0,0.0
AUDI,A3 1.2,2011,6,4,66.7,2,33.3,0,0.0
AUDI,A3 1.2,2012,5,3,60.0,2,40.0,0,0.0
AUDI,A3 1.2,2014,15,11,73.3,4,26.7,0,0.0
AUDI,A3 SE,2004,1,1,100.0,0,0.0,0,0.0
AUDI,A4,1995,15,4,26.7,11,73.3,0,0.0
AUDI,A4,1996,19,4,21.1,15,78.9,0,0.0
AUDI,A4,1997,36,10,27.8,26,72.2,0,0.0
AUDI,A4,1998,68,18,26.5,50,73.5,0,0.0
AUDI,A4,1999,88,29,33.0,59,67.0,0,0.0
AUDI,A4,2000,187,51,27.3,136,72.7,0,0.0
AUDI,A4,2001,323,85,26.3,238,73.7,0,0.0
AUDI,A4,2002,1155,303,26.2,852,73.8,1,0.1
AUDI,A4,2003,1651,472,28.6,1179,71.4,0,0.0
AUDI,A4,2004,1867,619,33.2,1248,66.8,0,0.0
AUDI,A4,2005,2743,996,36.3,1747,63.7,0,0.0
AUDI,A4,2006,2263,903,39.9,1360,60.1,2,0.1
AUDI,A4,2007,2046,818,40.0,1228,60.0,1,0.0
AUDI,A4,2008,3350,1473,44.0,1877,56.0,0,0.0
AUDI,A4,2009,1524,811,53.2,713,46.8,1,0.1
AUDI,A4,2010,3121,1914,61.3,1207,38.7,0,0.0
AUDI,A4,2011,726,455,62.7,271,37.3,0,0.0
AUDI,A4,2012,2139,1477,69.1,662,30.9,0,0.0
AUDI,A4,2013,549,412,75.0,137,25.0,0,0.0
AUDI,A4,2014,2204,1679,76.2,525,23.8,1,0.0
AUDI,A4,2015,114,92,80.7,22,19.3,0,0.0
AUDI,A4,2016,10,8,80.0,2,20.0,0,0.0
AUDI,A4,2017,1,1,100.0,0,0.0,0,0.0
AUDI,A4 1.8 TFSI 120,2008,1,1,100.0,0,0.0,0,0.0
AUDI,A4 1.9 TDI 100 BHP 4DR,2001,1,0,0.0,1,100.0,0,0.0
AUDI,A4 1.9 TDI 100 BHP 4DR,2003,2,0,0.0,2,100.0,0,0.0
AUDI,A4 1.9 TDI 113BHP 4DR,2005,4,0,0.0,4,100.0,0,0.0
AUDI,A4 1.9 TDI 113BHP 4DR,2006,1,1,100.0,0,0.0,0,0.0
AUDI,A4 1.9 TDI 113BHP 4DR,2007,2,2,100.0,0,0.0,0,0.0
AUDI,A4 1.9 TDI 115 BHP 4DR,2004,1,0,0.0,1,100.0,0,0.0
AUDI,A4 1.9 TDI 115 BHP 4DR,2005,1,0,0.0,1,100.0,0,0.0
AUDI,A4 1.9 TDI 115 BHP 4DR,2007,1,1,100.0,0,0.0,0,0.0
AUDI,A4 1.9 TDI 115 BHP 5DR,2004,2,1,50.0,1,50.0,0,0.0
AUDI,A4 1.9 TDI 115 BHP 5DR,2007,2,0,0.0,2,100.0,0,0.0
AUDI,A4 1.9 TDI 130 BHP 4DR,2001,1,0,0.0,1,100.0,0,0.0
AUDI,A4 1.9 TDI 130 BHP 4DR,2002,6,2,33.3,4,66.7,0,0.0
AUDI,A4 1.9 TDI 130 BHP 4DR,2003,3,0,0.0,3,100.0,0,0.0
AUDI,A4 1.9 TDI 130 BHP 4DR,2004,1,0,0.0,1,100.0,0,0.0
AUDI,A4 1.9 TDI 130BHP 6SPEED 4DR,2004,3,2,66.7,1,33.3,0,0.0
AUDI,A4 1.9 TDI 90BHP 5DR,1996,2,0,0.0,2,100.0,0,0.0
AUDI,A4 1.9 TDI 90BHP 5DR,1997,7,2,28.6,5,71.4,0,0.0
AUDI,A4 1.9 TDI 90BHP 5DR,1998,13,0,0.0,13,100.0,0,0.0
AUDI,A4 1.9 TDI 90BHP 5DR,1999,12,0,0.0,12,100.0,0,0.0
AUDI,A4 1.9 TDI 90BHP 5DR,2000,25,6,24.0,19,76.0,0,0.0
AUDI,A4 1.9 TDI 90BHP 5DR,2001,90,23,25.6,67,74.4,0,0.0
AUDI,A4 1.9 TDI 90BHP 5DR,2002,363,72,19.8,291,80.2,0,0.0
AUDI,A4 1.9 TDI 90BHP 5DR,2003,552,129,23.4,423,76.6,0,0.0
AUDI,A4 1.9 TDI 90BHP 5DR,2004,879,289,32.9,590,67.1,0,0.0
AUDI,A4 1.9 TDI 90BHP 5DR,2005,650,213,32.8,437,67.2,0,0.0
AUDI,A4 1.9 TDI 90BHP 5DR,2006,473,163,34.5,310,65.5,1,0.2
AUDI,A4 1.9 TDI 90BHP 5DR,2007,329,129,39.2,200,60.8,1,0.3
AUDI,A4 1.9 TDI 90BHP 5DR,2008,83,31,37.3,52,62.7,0,0.0
AUDI,A4 1.9 TDI SE 100BHP 4DR,2003,2,0,0.0,2,100.0,0,0.0
AUDI,A4 1.9 TDI SE 100BHP 4DR,2004,2,2,100.0,0,0.0,0,0.0
AUDI,A4 1.9 TDI SE 100BHP 5DR,2002,1,0,0.0,1,100.0,0,0.0
AUDI,A4 1.9 TDI SE 100BHP 5DR,2003,3,1,33.3,2,66.7,0,0.0
AUDI,A4 1.9 TDI SE 100BHP 5DR,2004,1,0,0.0,1,100.0,0,0.0
AUDI,A4 1.9 TDI SE 113BHP 05DR,2005,2,2,100.0,0,0.0,0,0.0
AUDI,A4 1.9 TDI SE 113BHP 05DR,2006,2,1,50.0,1,50.0,0,0.0
AUDI,A4 1.9 TDI SE 113BHP 05DR,2007,1,0,0.0,1,100.0,0,0.0
AUDI,A4 1.9 TDI SE 113BHP 05DR,2008,1,0,0.0,1,100.0,0,0.0
AUDI,A4 1.9 TDI SE 113BHP 4DR,2005,8,1,12.5,7,87.5,0,0.0
AUDI,A4 1.9 TDI SE 113BHP 4DR,2006,5,3,60.0,2,40.0,0,0.0
AUDI,A4 1.9 TDI SE 113BHP 4DR,2007,5,4,80.0,1,20.0,0,0.0
AUDI,A4 1.9 TDI SE 113BHP 4DR,2008,2,1,50.0,1,50.0,0,0.0
AUDI,A4 1.9 TDI SE 115BHP 4DR,2004,5,3,60.0,2,40.0,0,0.0
AUDI,A4 1.9 TDI SE 115BHP 4DR,2005,1,0,0.0,1,100.0,0,0.0
AUDI,A4 1.9 TDI SE 115BHP 4DR,2006,1,0,0.0,1,100.0,0,0.0
AUDI,A4 1.9 TDI SE 130BHP 4DR,2003,3,1,33.3,2,66.7,0,0.0
AUDI,A4 1.9 TDI SE 130BHP 5DR,1997,1,1,100.0,0,0.0,0,0.0
AUDI,A4 1.9 TDI SE 130BHP 5DR,1998,4,1,25.0,3,75.0,0,0.0
AUDI,A4 1.9 TDI SE 130BHP 5DR,1999,3,0,0.0,3,100.0,0,0.0
AUDI,A4 1.9 TDI SE 130BHP 5DR,2000,3,1,33.3,2,66.7,0,0.0
AUDI,A4 1.9 TDI SE 130BHP 5DR,2001,21,4,19.0,17,81.0,0,0.0
AUDI,A4 1.9 TDI SE 130BHP 5DR,2002,88,18,20.5,70,79.5,0,0.0
AUDI,A4 1.9 TDI SE 130BHP 5DR,2003,212,59,27.8,153,72.2,0,0.0
AUDI,A4 1.9 TDI SE 130BHP 5DR,2004,402,127,31.6,275,68.4,0,0.0
AUDI,A4 1.9 TDI SE 130BHP 5DR,2005,134,43,32.1,91,67.9,0,0.0
AUDI,A4 1.9 TDI SE 130BHP 5DR,2006,24,4,16.7,20,83.3,0,0.0
AUDI,A4 1.9 TDI SE 130BHP 5DR,2007,36,13,36.1,23,63.9,0,0.0
AUDI,A4 1.9 TDI SE 130BHP 5DR,2008,1,0,0.0,1,100.0,0,0.0
AUDI,A4 1.9 TDI SE 130BHP 5SP 4DR,2002,2,0,0.0,2,100.0,0,0.0
AUDI,A4 1.9 TDI SE 130BHP 6 SPEED,2003,6,1,16.7,5,83.3,0,0.0
AUDI,A4 1.9 TDI SE 130BHP 6 SPEED,2004,5,1,20.0,4,80.0,0,0.0
AUDI,A4 1.9 TDI SPORT 100BHP 4DR,2004,2,1,50.0,1,50.0,0,0.0
AUDI,A4 1.9 TDI SPORT 115BHP 4DR,2004,4,2,50.0,2,50.0,0,0.0
AUDI,A4 1.9 TDI SPORT 130BHP 4DR,2002,3,1,33.3,2,66.7,0,0.0
AUDI,A4 1.9 TDI SPORT 130BHP 4DR,2003,3,1,33.3,2,66.7,0,0.0
AUDI,A4 1.9 TDI SPORT 130BHP 4DR,2004,7,3,42.9,4,57.1,0,0.0
AUDI,A4 1.9 TDI SPORT 130BHP 5DR,2003,2,2,100.0,0,0.0,0,0.0
AUDI,A4 1.9 TDI SPORT 130BHP 6SPEED,2004,3,1,33.3,2,66.7,0,0.0
AUDI,A4 1.9TDI 130BHP 5DR,2002,1,0,0.0,1,100.0,0,0.0
AUDI,A4 1.9TDI QUATTRO SE 130BHP 4D,2004,1,1,100.0,0,0.0,0,0.0
AUDI,A4 1.9TDI QUATTRO SPORT 130BHP,2004,5,3,60.0,2,40.0,0,0.0
AUDI,A4 1.9TDI S LINE 113BHP 4DR,2005,1,1,100.0,0,0.0,0,0.0
AUDI,A4 1.9TDI S LINE 113BHP 4DR,2006,2,0,0.0,2,100.0,0,0.0
AUDI,A4 1.9TDI S LINE 113BHP 4DR,2007,2,1,50.0,1,50.0,0,0.0
AUDI,A4 1.9TDI SE 115BHP,2004,2,0,0.0,2,100.0,0,0.0
AUDI,A4 1.9TDI SE 130BHP 5SPEED 4DR,2002,1,0,0.0,1,100.0,0,0.0
AUDI,A4 1.9TDI SE 130BHP 5SPEED 4DR,2003,1,0,0.0,1,100.0,0,0.0
AUDI,A4 1.9TDI SPORT 130BHP 6SP 4DR,2003,4,1,25.0,3,75.0,0,0.0
AUDI,A4 1.9TDI SPORT 130BHP 6SP 4DR,2004,7,2,28.6,5,71.4,0,0.0
AUDI,A4 2.0 TDI 138BHP 4DR,2005,1,0,0.0,1,100.0,0,0.0
AUDI,A4 2.0 TDI SE 138BHP 5DR,2005,1,1,100.0,0,0.0,0,0.0
AUDI,A4 2.0TDI S/LINE SP ED 168BHP,2008,2,2,100.0,0,0.0,0,0.0
AUDI,A4 2.0TDI SLINE BLACK EDIT 134,2012,1,1,100.0,0,0.0,0,0.0
AUDI,A4 2.O TDI S LINE 138BHP 4DR,2005,1,1,100.0,0,0.0,0,0.0
AUDI,A4 ALLROAD,2010,1,1,100.0,0,0.0,0,0.0
AUDI,A4 ALLROAD,2011,1,1,100.0,0,0.0,0,0.0
AUDI,A4 ALLROAD,2012,1,1,100.0,0,0.0,0,0.0
AUDI,A4 ALLROAD,2014,2,1,50.0,1,50.0,0,0.0
AUDI,A4 CABRIOLET,2003,3,1,33.3,2,66.7,0,0.0
AUDI,A4 CABRIOLET,2004,1,0,0.0,1,100.0,0,0.0
AUDI,A4 CABRIOLET,2005,9,5,55.6,4,44.4,0,0.0
AUDI,A4 CABRIOLET,2006,6,2,33.3,4,66.7,0,0.0
AUDI,A4 CABRIOLET,2007,8,4,50.0,4,50.0,0,0.0
AUDI,A4 CABRIOLET,2008,4,3,75.0,1,25.0,0,0.0
AUDI,A4 SE,2005,1,1,100.0,0,0.0,0,0.0
AUDI,A4 TDI SE 130BHP 5 SPEED 4DR,2001,1,0,0.0,1,100.0,0,0.0
AUDI,A4 TDI SPORT 130BHP,2002,1,0,0.0,1,100.0,0,0.0
AUDI,A4A,2007,10,5,50.0,5,50.0,0,0.0
AUDI,A4A,2008,47,21,44.7,26,55.3,0,0.0
AUDI,A4A,2009,22,11,50.0,11,50.0,0,0.0
AUDI,A4A,2010,72,39,54.2,33,45.8,0,0.0
AUDI,A4A,2011,9,5,55.6,4,44.4,0,0.0
AUDI,A4A,2012,51,29,56.9,22,43.1,0,0.0
AUDI,A4A,2013,4,4,100.0,0,0.0,0,0.0
AUDI,A4A,2014,2,1,50.0,1,50.0,0,0.0
AUDI,A4A,2015,4,2,50.0,2,50.0,0,0.0
AUDI,A5,2007,26,18,69.2,8,30.8,0,0.0
AUDI,A5,2008,348,165,47.4,183,52.6,0,0.0
AUDI,A5,2009,194,107,55.2,87,44.8,0,0.0
AUDI,A5,2010,761,470,61.8,291,38.2,0,0.0
AUDI,A5,2011,204,116,56.9,88,43.1,0,0.0
AUDI,A5,2012,704,483,68.6,221,31.4,0,0.0
AUDI,A5,2013,255,186,72.9,69,27.1,0,0.0
AUDI,A5,2014,759,570,75.1,189,24.9,0,0.0
AUDI,A5,2015,29,24,82.8,5,17.2,0,0.0
AUDI,A5,2016,1,1,100.0,0,0.0,0,0.0
AUDI,A5 CABRIOLET,2009,4,4,100.0,0,0.0,0,0.0
AUDI,A5 CABRIOLET,2010,12,6,50.0,6,50.0,0,0.0
AUDI,A5 CABRIOLET,2011,5,5,100.0,0,0.0,0,0.0
AUDI,A5 CABRIOLET,2012,24,18,75.0,6,25.0,0,0.0
AUDI,A5 CABRIOLET,2013,6,4,66.7,2,33.3,0,0.0
AUDI,A5 CABRIOLET,2014,8,7,87.5,1,12.5,0,0.0
AUDI,A6,1995,7,2,28.6,5,71.4,0,0.0
AUDI,A6,1996,8,0,0.0,8,100.0,0,0.0
AUDI,A6,1997,11,3,27.3,8,72.7,0,0.0
AUDI,A6,1998,26,7,26.9,19,73.1,1,3.8
AUDI,A6,1999,37,11,29.7,26,70.3,0,0.0
AUDI,A6,2000,110,27,24.5,83,75.5,0,0.0
AUDI,A6,2001,95,39,41.1,56,58.9,0,0.0
AUDI,A6,2002,261,82,31.4,179,68.6,0,0.0
AUDI,A6,2003,380,123,32.4,257,67.6,0,0.0
AUDI,A6,2004,517,177,34.2,340,65.8,0,0.0
AUDI,A6,2005,832,349,41.9,483,58.1,0,0.0
AUDI,A6,2006,1002,447,44.6,555,55.4,2,0.2
AUDI,A6,2007,1111,506,45.5,605,54.5,1,0.1
AUDI,A6,2008,661,342,51.7,319,48.3,0,0.0
AUDI,A6,2009,538,308,57.2,230,42.8,0,0.0
AUDI,A6,2010,1219,742,60.9,477,39.1,1,0.1
AUDI,A6,2011,329,222,67.5,107,32.5,0,0.0
AUDI,A6,2012,2040,1502,73.6,538,26.4,1,0.0
AUDI,A6,2013,522,402,77.0,120,23.0,1,0.2
AUDI,A6,2014,1953,1503,77.0,450,23.0,1,0.1
AUDI,A6,2015,161,134,83.2,27,16.8,0,0.0
AUDI,A6,2016,15,14,93.3,1,6.7,0,0.0
AUDI,A6,2017,3,3,100.0,0,0.0,0,0.0
AUDI,A6,2018,1,1,100.0,0,0.0,0,0.0
AUDI,A6 1.8 TSE 150BHP 4 DR,2001,1,0,0.0,1,100.0,0,0.0
AUDI,A6 1.9 TDI AVANT SPORT,2003,1,0,0.0,1,100.0,0,0.0
AUDI,A6 1.9 TDI SE 130BHP,2004,1,0,0.0,1,100.0,0,0.0
AUDI,A6 1.9 TDI SE 130BHP 5DR,2003,2,1,50.0,1,50.0,0,0.0
AUDI,A6 1.9 TDI SE 130BHP 5DR,2004,1,0,0.0,1,100.0,0,0.0
AUDI,A6 1.9TDI SPORT 130BHP,2002,4,1,25.0,3,75.0,0,0.0
AUDI,A6 1.9TDI SPORT 130BHP,2004,1,1,100.0,0,0.0,0,0.0
AUDI,A6 2.0 TDI 138BHP 4DR,2005,1,1,100.0,0,0.0,0,0.0
AUDI,A6 2.0 TDI S LINE 138BHP 4DR,2005,1,0,0.0,1,100.0,0,0.0
AUDI,A6 ALLROAD3.0TDI QUATTRO229BHP,2006,1,1,100.0,0,0.0,0,0.0
AUDI,A6A,2007,2,1,50.0,1,50.0,0,0.0
AUDI,A6A,2008,5,3,60.0,2,40.0,0,0.0
AUDI,A6A,2009,4,2,50.0,2,50.0,0,0.0
AUDI,A6A,2011,1,1,100.0,0,0.0,0,0.0
AUDI,A7,2010,1,0,0.0,1,100.0,0,0.0
AUDI,A7,2011,13,11,84.6,2,15.4,0,0.0
AUDI,A7,2012,62,44,71.0,18,29.0,0,0.0
AUDI,A7,2013,8,5,62.5,3,37.5,0,0.0
AUDI,A7,2014,48,36,75.0,12,25.0,1,2.1
AUDI,A7,2015,6,6,100.0,0,0.0,0,0.0
AUDI,A7 TDI,2011,21,14,66.7,7,33.3,0,0.0
AUDI,A7 TDI,2012,58,45,77.6,13,22.4,0,0.0
AUDI,A7 TDI,2013,20,11,55.0,9,45.0,0,0.0
AUDI,A7 TDI,2014,47,39,83.0,8,17.0,0,0.0
AUDI,A7 TDI,2015,11,9,81.8,2,18.2,0,0.0
AUDI,A8,1996,1,1,100.0,0,0.0,0,0.0
AUDI,A8,1997,2,2,100.0,0,0.0,0,0.0
AUDI,A8,2001,1,0,0.0,1,100.0,0,0.0
AUDI,A8,2003,2,1,50.0,1,50.0,0,0.0
AUDI,A8,2004,12,6,50.0,6,50.0,0,0.0
AUDI,A8,2005,25,11,44.0,14,56.0,0,0.0
AUDI,A8,2006,19,7,36.8,12,63.2,1,5.3
AUDI,A8,2007,40,18,45.0,22,55.0,1,2.5
AUDI,A8,2008,25,11,44.0,14,56.0,0,0.0
AUDI,A8,2009,15,7,46.7,8,53.3,1,6.7
AUDI,A8,2010,26,8,30.8,18,69.2,0,0.0
AUDI,A8,2011,11,8,72.7,3,27.3,0,0.0
AUDI,A8,2012,47,29,61.7,18,38.3,0,0.0
AUDI,A8,2013,11,8,72.7,3,27.3,0,0.0
AUDI,A8,2014,56,36,64.3,20,35.7,0,0.0
AUDI,A8,2015,10,7,70.0,3,30.0,0,0.0
AUDI,A8,2016,5,3,60.0,2,40.0,0,0.0
AUDI,A8,2018,1,1,100.0,0,0.0,0,0.0
AUDI,A8L,2011,1,0,0.0,1,100.0,0,0.0
AUDI,A8L,2012,7,5,71.4,2,28.6,0,0.0
AUDI,A8L,2013,1,0,0.0,1,100.0,0,0.0
AUDI,A8L,2015,1,1,100.0,0,0.0,0,0.0
AUDI,ALLROAD,2000,2,0,0.0,2,100.0,0,0.0
AUDI,ALLROAD,2001,1,0,0.0,1,100.0,0,0.0
AUDI,ALLROAD,2002,11,4,36.4,7,63.6,0,0.0
AUDI,ALLROAD,2003,15,4,26.7,11,73.3,0,0.0
AUDI,ALLROAD,2004,11,2,18.2,9,81.8,0,0.0
AUDI,ALLROAD,2005,7,2,28.6,5,71.4,0,0.0
AUDI,ALLROAD,2006,5,1,20.0,4,80.0,0,0.0
AUDI,ALLROAD,2010,1,1,100.0,0,0.0,0,0.0
AUDI,ALLROAD,2012,2,1,50.0,1,50.0,0,0.0
AUDI,OTHER,1984,1,0,0.0,1,100.0,0,0.0
AUDI,OTHER,1985,2,1,50.0,1,50.0,0,0.0
AUDI,OTHER,1986,3,1,33.3,2,66.7,0,0.0
AUDI,OTHER,1987,2,2,100.0,0,0.0,0,0.0
AUDI,OTHER,1988,1,0,0.0,1,100.0,0,0.0
AUDI,OTHER,1990,4,2,50.0,2,50.0,0,0.0
AUDI,OTHER,1991,1,0,0.0,1,100.0,0,0.0
AUDI,OTHER,1992,1,0,0.0,1,100.0,0,0.0
AUDI,OTHER,1993,2,1,50.0,1,50.0,0,0.0
AUDI,OTHER,1994,12,2,16.7,10,83.3,0,0.0
AUDI,OTHER,1995,6,2,33.3,4,66.7,0,0.0
AUDI,OTHER,1996,8,2,25.0,6,75.0,0,0.0
AUDI,OTHER,1997,22,7,31.8,15,68.2,0,0.0
AUDI,OTHER,1998,42,19,45.2,23,54.8,0,0.0
AUDI,OTHER,1999,31,13,41.9,18,58.1,0,0.0
AUDI,OTHER,2000,40,16,40.0,24,60.0,0,0.0
AUDI,OTHER,2001,15,7,46.7,8,53.3,0,0.0
AUDI,OTHER,2002,13,5,38.5,8,61.5,0,0.0
AUDI,OTHER,2003,15,4,26.7,11,73.3,0,0.0
AUDI,OTHER,2004,14,6,42.9,8,57.1,0,0.0
AUDI,OTHER,2005,4,2,50.0,2,50.0,0,0.0
AUDI,OTHER,2006,1,1,100.0,0,0.0,0,0.0
AUDI,OTHER,2007,1,0,0.0,1,100.0,0,0.0
AUDI,OTHER,2010,1,1,100.0,0,0.0,0,0.0
AUDI,Q3,2011,1,1,100.0,0,0.0,0,0.0
AUDI,Q3,2012,274,215,78.5,59,21.5,0,0.0
AUDI,Q3,2013,40,33,82.5,7,17.5,0,0.0
AUDI,Q3,2014,309,255,82.5,54,17.5,3,1.0
AUDI,Q3,2015,28,24,85.7,4,14.3,0,0.0
AUDI,Q5,2008,1,1,100.0,0,0.0,0,0.0
AUDI,Q5,2009,31,24,77.4,7,22.6,0,0.0
AUDI,Q5,2010,77,48,62.3,29,37.7,0,0.0
AUDI,Q5,2011,19,12,63.2,7,36.8,0,0.0
AUDI,Q5,2012,200,154,77.0,46,23.0,0,0.0
AUDI,Q5,2013,33,24,72.7,9,27.3,0,0.0
AUDI,Q5,2014,287,214,74.6,73,25.4,2,0.7
AUDI,Q5,2015,20,20,100.0,0,0.0,0,0.0
AUDI,Q7,2006,75,34,45.3,41,54.7,0,0.0
AUDI,Q7,2007,312,171,54.8,141,45.2,2,0.6
AUDI,Q7,2008,134,53,39.6,81,60.4,1,0.7
AUDI,Q7,2009,6,3,50.0,3,50.0,0,0.0
AUDI,Q7,2010,13,6,46.2,7,53.8,0,0.0
AUDI,Q7,2011,9,6,66.7,3,33.3,0,0.0
AUDI,Q7,2012,50,43,86.0,7,14.0,0,0.0
AUDI,Q7,2013,9,6,66.7,3,33.3,0,0.0
AUDI,Q7,2014,52,42,80.8,10,19.2,0,0.0
AUDI,Q7,2015,5,3,60.0,2,40.0,0,0.0
AUDI,Q7,2017,1,1,100.0,0,0.0,0,0.0
AUDI,Q7 3.0 TDI QUATTRO S LINE 5DR,2006,1,0,0.0,1,100.0,0,0.0
AUDI,R8,2007,1,1,100.0,0,0.0,0,0.0
AUDI,R8,2008,7,2,28.6,5,71.4,0,0.0
AUDI,R8,2010,1,1,100.0,0,0.0,0,0.0
AUDI,R8,2012,1,0,0.0,1,100.0,0,0.0
AUDI,RS4,2001,1,0,0.0,1,100.0,0,0.0
AUDI,RS4,2006,6,5,83.3,1,16.7,0,0.0
AUDI,RS4,2007,15,11,73.3,4,26.7,0,0.0
AUDI,RS4,2013,1,1,100.0,0,0.0,0,0.0
AUDI,RS4,2014,1,1,100.0,0,0.0,0,0.0
AUDI,RS6,2002,1,0,0.0,1,100.0,0,0.0
AUDI,RS6,2003,8,5,62.5,3,37.5,0,0.0
AUDI,RS6,2004,2,2,100.0,0,0.0,0,0.0
AUDI,RS6,2008,1,0,0.0,1,100.0,0,0.0
AUDI,RS6,2009,2,2,100.0,0,0.0,0,0.0
AUDI,RS6,2010,1,0,0.0,1,100.0,0,0.0
AUDI,RS6,2014,1,0,0.0,1,100.0,0,0.0
AUDI,S3,1999,6,2,33.3,4,66.7,0,0.0
AUDI,S3,2000,2,2,100.0,0,0.0,0,0.0
AUDI,S3,2001,16,5,31.3,11,68.8,0,0.0
AUDI,S3,2002,21,6,28.6,15,71.4,1,4.8
AUDI,S3,2003,7,5,71.4,2,28.6,1,14.3
AUDI,S3,2007,21,13,61.9,8,38.1,0,0.0
AUDI,S3,2008,10,6,60.0,4,40.0,0,0.0
AUDI,S3,2009,4,1,25.0,3,75.0,0,0.0
AUDI,S3,2010,6,4,66.7,2,33.3,0,0.0
AUDI,S3,2011,3,3,100.0,0,0.0,0,0.0
AUDI,S3,2012,10,7,70.0,3,30.0,0,0.0
AUDI,S3,2013,2,0,0.0,2,100.0,0,0.0
AUDI,S3,2014,14,7,50.0,7,50.0,0,0.0
AUDI,S3,2015,1,1,100.0,0,0.0,0,0.0
AUDI,S4,1998,1,0,0.0,1,100.0,0,0.0
AUDI,S4,1999,1,0,0.0,1,100.0,0,0.0
AUDI,S4,2000,3,2,66.7,1,33.3,0,0.0
AUDI,S4,2003,2,0,0.0,2,100.0,0,0.0
AUDI,S4,2004,1,1,100.0,0,0.0,0,0.0
AUDI,S4,2005,2,1,50.0,1,50.0,0,0.0
AUDI,S4,2006,2,2,100.0,0,0.0,0,0.0
AUDI,S4,2007,2,2,100.0,0,0.0,0,0.0
AUDI,S4,2009,1,1,100.0,0,0.0,0,0.0
AUDI,S4,2010,4,2,50.0,2,50.0,0,0.0
AUDI,S4,2014,1,1,100.0,0,0.0,0,0.0
AUDI,S5,2007,3,2,66.7,1,33.3,0,0.0
AUDI,S5,2008,5,3,60.0,2,40.0,0,0.0
AUDI,S5,2010,3,3,100.0,0,0.0,0,0.0
AUDI,S5,2012,2,1,50.0,1,50.0,0,0.0
AUDI,S5,2014,1,1,100.0,0,0.0,0,0.0
AUDI,S5,2015,1,1,100.0,0,0.0,0,0.0
AUDI,S6,1996,1,0,0.0,1,100.0,0,0.0
AUDI,S6,2002,2,2,100.0,0,0.0,0,0.0
AUDI,S6,2007,4,1,25.0,3,75.0,0,0.0
AUDI,S7,2014,1,1,100.0,0,0.0,0,0.0
AUDI,S8,1997,1,1,100.0,0,0.0,0,0.0
AUDI,S8,1998,1,0,0.0,1,100.0,0,0.0
AUDI,S8,2001,2,2,100.0,0,0.0,0,0.0
AUDI,S8,2002,2,1,50.0,1,50.0,0,0.0
AUDI,S8,2006,8,3,37.5,5,62.5,0,0.0
AUDI,S8,2014,4,1,25.0,3,75.0,0,0.0
AUDI,TT,1999,49,17,34.7,32,65.3,0,0.0
AUDI,TT,2000,103,26,25.2,77,74.8,1,1.0
AUDI,TT,2001,131,40,30.5,91,69.5,0,0.0
AUDI,TT,2002,170,66,38.8,104,61.2,0,0.0
AUDI,TT,2003,135,33,24.4,102,75.6,0,0.0
AUDI,TT,2004,99,41,41.4,58,58.6,0,0.0
AUDI,TT,2005,81,39,48.1,42,51.9,0,0.0
AUDI,TT,2006,58,30,51.7,28,48.3,0,0.0
AUDI,TT,2007,236,150,63.6,86,36.4,0,0.0
AUDI,TT,2008,99,56,56.6,43,43.4,0,0.0
AUDI,TT,2009,39,30,76.9,9,23.1,0,0.0
AUDI,TT,2010,51,41,80.4,10,19.6,1,2.0
AUDI,TT,2011,21,13,61.9,8,38.1,0,0.0
AUDI,TT,2012,31,28,90.3,3,9.7,0,0.0
AUDI,TT,2013,17,14,82.4,3,17.6,0,0.0
AUDI,TT,2014,18,17,94.4,1,5.6,0,0.0
AUDI,TT,2015,4,3,75.0,1,25.0,0,0.0
AUDI,TT 1.8 T 190BHP 5SP 3DR,2006,1,1,100.0,0,0.0,0,0.0
AUDI,TTC,2014,8,7,87.5,1,12.5,0,0.0
AUDI,TTS,2008,6,4,66.7,2,33.3,0,0.0
AUDI,TTS,2009,2,0,0.0,2,100.0,0,0.0
AUDI,TTS,2011,1,1,100.0,0,0.0,0,0.0
AUDI,TTS,2013,1,1,100.0,0,0.0,0,0.0
AUSTIN,1300,1993,1,0,0.0,1,100.0,0,0.0
AUSTIN,COOPER,1990,1,0,0.0,1,100.0,0,0.0
AUSTIN,COOPER,1991,3,0,0.0,3,100.0,0,0.0
AUSTIN,COOPER,1993,1,0,0.0,1,100.0,0,0.0
AUSTIN,COOPER,1994,6,0,0.0,6,100.0,0,0.0
AUSTIN,COOPER,1995,4,2,50.0,2,50.0,0,0.0
AUSTIN,COOPER,1996,4,0,0.0,4,100.0,0,0.0
AUSTIN,COOPER,1997,10,4,40.0,6,60.0,0,0.0
AUSTIN,COOPER,1998,12,6,50.0,6,50.0,0,0.0
AUSTIN,COOPER,1999,19,5,26.3,14,73.7,0,0.0
AUSTIN,COOPER,2000,19,3,15.8,16,84.2,0,0.0
AUSTIN,COOPER,2001,7,1,14.3,6,85.7,0,0.0
AUSTIN,COOPER,2002,1,1,100.0,0,0.0,0,0.0
AUSTIN,MAESTRO,1986,1,1,100.0,0,0.0,0,0.0
AUSTIN,MINI,1980,1,0,0.0,1,100.0,0,0.0
AUSTIN,MINI,1983,3,1,33.3,2,66.7,0,0.0
AUSTIN,MINI,1984,2,1,50.0,1,50.0,0,0.0
AUSTIN,MINI,1985,2,0,0.0,2,100.0,0,0.0
AUSTIN,MINI,1986,7,1,14.3,6,85.7,0,0.0
AUSTIN,MINI,1987,5,0,0.0,5,100.0,0,0.0
AUSTIN,MINI,1988,7,4,57.1,3,42.9,0,0.0
AUSTIN,MINI,1989,12,4,33.3,8,66.7,0,0.0
AUSTIN,MINI,1990,15,3,20.0,12,80.0,0,0.0
AUSTIN,MINI,1991,8,2,25.0,6,75.0,0,0.0
AUSTIN,MINI,1992,10,2,20.0,8,80.0,0,0.0
AUSTIN,MINI,1993,14,6,42.9,8,57.1,0,0.0
AUSTIN,MINI,1994,19,3,15.8,16,84.2,0,0.0
AUSTIN,MINI,1995,8,3,37.5,5,62.5,0,0.0
AUSTIN,MINI,1996,20,6,30.0,14,70.0,0,0.0
AUSTIN,MINI,1997,7,2,28.6,5,71.4,0,0.0
AUSTIN,MINI,1998,3,1,33.3,2,66.7,0,0.0
AUSTIN,MINI,1999,4,1,25.0,3,75.0,0,0.0
AUSTIN,MINI,2000,5,1,20.0,4,80.0,0,0.0
AUSTIN,OTHER,1954,1,1,100.0,0,0.0,0,0.0
AUSTIN,OTHER,1980,1,1,100.0,0,0.0,0,0.0
AUSTIN,OTHER,1981,1,0,0.0,1,100.0,0,0.0
AUSTIN,OTHER,1985,2,1,50.0,1,50.0,1,50.0
AUSTIN,OTHER,1986,1,0,0.0,1,100.0,0,0.0
AUSTIN,PRINCESS,1965,1,0,0.0,1,100.0,0,0.0
AUSTIN ROVER,820,1987,1,1,100.0,0,0.0,0,0.0
AUSTIN ROVER,820,1999,1,1,100.0,0,0.0,0,0.0
AUSTIN ROVER,827,1996,1,1,100.0,0,0.0,0,0.0
BADSWORTH,2.0 KITCAR 4DR,2001,2,1,50.0,1,50.0,0,0.0
BADSWORTH,LAUNDELETTE,2012,1,1,100.0,0,0.0,0,0.0
BEAUFORD,OTHER,1979,1,1,100.0,0,0.0,0,0.0
BEAUFORD,OTHER,1982,2,2,100.0,0,0.0,0,0.0
BEAUFORD,OTHER,1998,1,0,0.0,1,100.0,0,0.0
BEAUFORD,OTHER,1999,1,1,100.0,0,0.0,0,0.0
BEAUFORD,OTHER,2004,2,0,0.0,2,100.0,0,0.0
BEAUFORD,OTHER,2005,2,0,0.0,2,100.0,0,0.0
BEAUFORD,OTHER,2007,4,1,25.0,3,75.0,0,0.0
BEAUFORD,OTHER,2009,4,2,50.0,2,50.0,0,0.0
BEAUFORD,TOURER,2002,2,0,0.0,2,100.0,0,0.0
BEAUFORD,TOURER,2004,2,0,0.0,2,100.0,0,0.0
BENTLEY,ARNAGE,2002,1,0,0.0,1,100.0,0,0.0
BENTLEY,ARNAGE,2007,1,0,0.0,1,100.0,0,0.0
BENTLEY,CONTINENTAL,2004,2,1,50.0,1,50.0,0,0.0
BENTLEY,CONTINENTAL,2008,1,1,100.0,0,0.0,0,0.0
BENTLEY,CONTINENTAL,2009,1,1,100.0,0,0.0,0,0.0
BENTLEY,CONTINENTAL,2011,1,1,100.0,0,0.0,0,0.0
BENTLEY,CONTINENTAL,2012,4,3,75.0,1,25.0,0,0.0
BENTLEY,CONTINENTAL,2013,1,1,100.0,0,0.0,0,0.0
BENTLEY,CONTINENTAL,2014,2,0,0.0,2,100.0,0,0.0
BENTLEY,OTHER,1952,1,0,0.0,1,100.0,0,0.0
BENTLEY,OTHER,1954,1,0,0.0,1,100.0,0,0.0
BENTLEY,OTHER,1960,1,1,100.0,0,0.0,0,0.0
BENTLEY,OTHER,1961,3,1,33.3,2,66.7,0,0.0
BENTLEY,OTHER,1962,1,0,0.0,1,100.0,0,0.0
BENTLEY,OTHER,1964,1,0,0.0,1,100.0,0,0.0
BENTLEY,OTHER,1986,1,1,100.0,0,0.0,0,0.0
BENTLEY,OTHER,1987,1,0,0.0,1,100.0,0,0.0
BENTLEY,OTHER,1988,3,1,33.3,2,66.7,0,0.0
BENTLEY,OTHER,1990,3,1,33.3,2,66.7,0,0.0
BENTLEY,OTHER,1991,2,0,0.0,2,100.0,0,0.0
BENTLEY,OTHER,1994,2,2,100.0,0,0.0,0,0.0
BENTLEY,OTHER,1995,1,0,0.0,1,100.0,0,0.0
BENTLEY,OTHER,1996,1,0,0.0,1,100.0,0,0.0
BENTLEY,OTHER,1997,1,0,0.0,1,100.0,0,0.0
BENTLEY,OTHER,1998,2,1,50.0,1,50.0,0,0.0
BENTLEY,OTHER,1999,2,2,100.0,0,0.0,0,0.0
BENTLEY,OTHER,2000,5,2,40.0,3,60.0,0,0.0
BENTLEY,OTHER,2002,3,1,33.3,2,66.7,0,0.0
BENTLEY,OTHER,2003,2,0,0.0,2,100.0,0,0.0
BENTLEY,OTHER,2004,8,3,37.5,5,62.5,0,0.0
BENTLEY,OTHER,2005,17,13,76.5,4,23.5,0,0.0
BENTLEY,OTHER,2006,12,5,41.7,7,58.3,0,0.0
BENTLEY,OTHER,2007,23,13,56.5,10,43.5,0,0.0
BENTLEY,OTHER,2008,4,1,25.0,3,75.0,0,0.0
BENTLEY,OTHER,2009,4,1,25.0,3,75.0,0,0.0
BENTLEY,OTHER,2010,1,1,100.0,0,0.0,0,0.0
BENTLEY,OTHER,2012,1,0,0.0,1,100.0,0,0.0
BENTLEY,OTHER,2014,1,1,100.0,0,0.0,0,0.0
BINZ,OTHER,2012,6,6,100.0,0,0.0,0,0.0
BINZ,OTHER,2014,1,1,100.0,0,0.0,0,0.0
BMW,1 SERIES,2011,1,1,100.0,0,0.0,0,0.0
BMW,114,2012,1,1,100.0,0,0.0,0,0.0
BMW,114,2013,20,18,90.0,2,10.0,0,0.0
BMW,114,2014,37,31,83.8,6,16.2,0,0.0
BMW,114,2015,2,2,100.0,0,0.0,0,0.0
BMW,116,2004,64,36,56.3,28,43.8,0,0.0
BMW,116,2005,629,337,53.6,292,46.4,0,0.0
BMW,116,2006,260,158,60.8,102,39.2,0,0.0
BMW,116,2007,322,208,64.6,114,35.4,0,0.0
BMW,116,2008,149,108,72.5,41,27.5,0,0.0
BMW,116,2009,51,38,74.5,13,25.5,0,0.0
BMW,116,2010,188,123,65.4,65,34.6,0,0.0
BMW,116,2011,43,33,76.7,10,23.3,0,0.0
BMW,116,2012,344,271,78.8,73,21.2,0,0.0
BMW,116,2013,69,61,88.4,8,11.6,0,0.0
BMW,116,2014,358,312,87.2,46,12.8,0,0.0
BMW,116,2015,18,16,88.9,2,11.1,0,0.0
BMW,118,2004,36,13,36.1,23,63.9,0,0.0
BMW,118,2005,156,64,41.0,92,59.0,0,0.0
BMW,118,2006,93,45,48.4,48,51.6,0,0.0
BMW,118,2007,99,57,57.6,42,42.4,0,0.0
BMW,118,2008,169,87,51.5,82,48.5,0,0.0
BMW,118,2009,53,29,54.7,24,45.3,0,0.0
BMW,118,2010,130,85,65.4,45,34.6,0,0.0
BMW,118,2011,32,22,68.8,10,31.3,0,0.0
BMW,118,2012,74,58,78.4,16,21.6,0,0.0
BMW,118,2013,22,16,72.7,6,27.3,0,0.0
BMW,118,2014,15,12,80.0,3,20.0,0,0.0
BMW,118,2015,1,1,100.0,0,0.0,0,0.0
BMW,120,2004,18,7,38.9,11,61.1,0,0.0
BMW,120,2005,110,50,45.5,60,54.5,0,0.0
BMW,120,2006,35,22,62.9,13,37.1,0,0.0
BMW,120,2007,12,7,58.3,5,41.7,0,0.0
BMW,120,2008,100,46,46.0,54,54.0,0,0.0
BMW,120,2009,31,21,67.7,10,32.3,0,0.0
BMW,120,2010,16,6,37.5,10,62.5,0,0.0
BMW,120,2011,9,5,55.6,4,44.4,0,0.0
BMW,120,2012,17,14,82.4,3,17.6,0,0.0
BMW,120,2013,7,6,85.7,1,14.3,0,0.0
BMW,120,2014,8,7,87.5,1,12.5,0,0.0
BMW,120,2015,1,1,100.0,0,0.0,0,0.0
BMW,123,2007,3,2,66.7,1,33.3,0,0.0
BMW,123,2008,13,8,61.5,5,38.5,0,0.0
BMW,123,2009,9,4,44.4,5,55.6,0,0.0
BMW,123,2010,4,2,50.0,2,50.0,0,0.0
BMW,123,2011,1,1,100.0,0,0.0,0,0.0
BMW,123,2012,1,1,100.0,0,0.0,0,0.0
BMW,125,2010,1,1,100.0,0,0.0,0,0.0
BMW,125,2014,2,2,100.0,0,0.0,0,0.0
BMW,130,2006,1,1,100.0,0,0.0,0,0.0
BMW,130,2007,1,1,100.0,0,0.0,0,0.0
BMW,130,2008,1,0,0.0,1,100.0,0,0.0
BMW,135,2007,1,1,100.0,0,0.0,0,0.0
BMW,135,2011,1,1,100.0,0,0.0,0,0.0
BMW,18,2014,1,0,0.0,1,100.0,0,0.0
BMW,216,2015,7,6,85.7,1,14.3,0,0.0
BMW,218,2014,67,64,95.5,3,4.5,0,0.0
BMW,218,2015,24,23,95.8,1,4.2,0,0.0
BMW,220,2014,27,25,92.6,2,7.4,0,0.0
BMW,220,2015,1,0,0.0,1,100.0,0,0.0
BMW,225,2014,1,1,100.0,0,0.0,0,0.0
BMW,3 SERIES,1996,2,0,0.0,2,100.0,0,0.0
BMW,3 SERIES,1997,1,0,0.0,1,100.0,0,0.0
BMW,3 SERIES,1998,2,1,50.0,1,50.0,0,0.0
BMW,3 SERIES,1999,2,0,0.0,2,100.0,0,0.0
BMW,3 SERIES,2000,2,1,50.0,1,50.0,0,0.0
BMW,3 SERIES,2007,1,1,100.0,0,0.0,0,0.0
BMW,3 SERIES,2008,2,1,50.0,1,50.0,0,0.0
BMW,3 SERIES,2009,10,7,70.0,3,30.0,0,0.0
BMW,3 SERIES,2010,2,1,50.0,1,50.0,0,0.0
BMW,3 SERIES,2011,1,1,100.0,0,0.0,0,0.0
BMW,316,1982,1,0,0.0,1,100.0,0,0.0
BMW,316,1983,3,2,66.7,1,33.3,0,0.0
BMW,316,1985,1,1,100.0,0,0.0,0,0.0
BMW,316,1986,3,3,100.0,0,0.0,0,0.0
BMW,316,1987,6,3,50.0,3,50.0,0,0.0
BMW,316,1988,3,0,0.0,3,100.0,0,0.0
BMW,316,1989,3,2,66.7,1,33.3,0,0.0
BMW,316,1990,10,3,30.0,7,70.0,0,0.0
BMW,316,1991,9,6,66.7,3,33.3,0,0.0
BMW,316,1993,11,5,45.5,6,54.5,0,0.0
BMW,316,1994,4,2,50.0,2,50.0,0,0.0
BMW,316,1995,5,1,20.0,4,80.0,0,0.0
BMW,316,1996,10,2,20.0,8,80.0,0,0.0
BMW,316,1997,8,2,25.0,6,75.0,0,0.0
BMW,316,1998,21,8,38.1,13,61.9,0,0.0
BMW,316,1999,13,0,0.0,13,100.0,0,0.0
BMW,316,2000,27,6,22.2,21,77.8,0,0.0
BMW,316,2001,34,10,29.4,24,70.6,0,0.0
BMW,316,2002,39,11,28.2,28,71.8,0,0.0
BMW,316,2003,71,22,31.0,49,69.0,0,0.0
BMW,316,2004,192,87,45.3,105,54.7,0,0.0
BMW,316,2005,56,18,32.1,38,67.9,0,0.0
BMW,316,2006,461,264,57.3,197,42.7,0,0.0
BMW,316,2007,842,478,56.8,364,43.2,0,0.0
BMW,316,2008,169,109,64.5,60,35.5,0,0.0
BMW,316,2009,12,5,41.7,7,58.3,0,0.0
BMW,316,2010,289,167,57.8,122,42.2,0,0.0
BMW,316,2011,71,46,64.8,25,35.2,0,0.0
BMW,316,2012,517,381,73.7,136,26.3,0,0.0
BMW,316,2013,124,97,78.2,27,21.8,0,0.0
BMW,316,2014,317,267,84.2,50,15.8,0,0.0
BMW,316,2015,25,20,80.0,5,20.0,0,0.0
BMW,316 I E46 SE,2003,1,1,100.0,0,0.0,0,0.0
BMW,316I,1999,2,1,50.0,1,50.0,0,0.0
BMW,316I,2000,33,12,36.4,21,63.6,0,0.0
BMW,316I,2001,73,23,31.5,50,68.5,0,0.0
BMW,316I,2002,1,1,100.0,0,0.0,0,0.0
BMW,316I,2005,2,1,50.0,1,50.0,0,0.0
BMW,316I,2008,18,7,38.9,11,61.1,0,0.0
BMW,318,1984,1,1,100.0,0,0.0,0,0.0
BMW,318,1988,1,0,0.0,1,100.0,0,0.0
BMW,318,1989,6,3,50.0,3,50.0,0,0.0
BMW,318,1990,43,10,23.3,33,76.7,0,0.0
BMW,318,1991,16,4,25.0,12,75.0,0,0.0
BMW,318,1992,15,7,46.7,8,53.3,0,0.0
BMW,318,1993,13,4,30.8,9,69.2,0,0.0
BMW,318,1994,3,1,33.3,2,66.7,0,0.0
BMW,318,1995,5,1,20.0,4,80.0,0,0.0
BMW,318,1996,17,2,11.8,15,88.2,0,0.0
BMW,318,1997,35,9,25.7,26,74.3,0,0.0
BMW,318,1998,38,11,28.9,27,71.1,0,0.0
BMW,318,1999,53,12,22.6,41,77.4,0,0.0
BMW,318,2000,59,9,15.3,50,84.7,0,0.0
BMW,318,2001,106,34,32.1,72,67.9,0,0.0
BMW,318,2002,73,30,41.1,43,58.9,0,0.0
BMW,318,2003,136,39,28.7,97,71.3,0,0.0
BMW,318,2004,409,139,34.0,270,66.0,0,0.0
BMW,318,2005,392,142,36.2,250,63.8,0,0.0
BMW,318,2006,1187,542,45.7,645,54.3,0,0.0
BMW,318,2007,981,510,52.0,471,48.0,0,0.0
BMW,318,2008,1342,662,49.3,680,50.7,0,0.0
BMW,318,2009,289,143,49.5,146,50.5,0,0.0
BMW,318,2010,627,366,58.4,261,41.6,0,0.0
BMW,318,2011,164,97,59.1,67,40.9,0,0.0
BMW,318,2012,344,254,73.8,90,26.2,0,0.0
BMW,318,2013,81,68,84.0,13,16.0,0,0.0
BMW,318,2014,594,491,82.7,103,17.3,0,0.0
BMW,318,2015,17,15,88.2,2,11.8,0,0.0
BMW,318 E46 2.0 CI M SPORT 2DR,2006,1,1,100.0,0,0.0,0,0.0
BMW,318 E90 D ES 4DR,2006,1,0,0.0,1,100.0,0,0.0
BMW,318 E90 D SE 4DR,2008,1,1,100.0,0,0.0,0,0.0
BMW,318 E91 D SE TOURING 5DR,2007,1,1,100.0,0,0.0,0,0.0
BMW,318D EDITION M SPORT,2008,2,1,50.0,1,50.0,0,0.0
BMW,318I,2003,8,3,37.5,5,62.5,0,0.0
BMW,318I,2004,15,7,46.7,8,53.3,0,0.0
BMW,318I,2005,2,1,50.0,1,50.0,0,0.0
BMW,318I,2006,41,18,43.9,23,56.1,0,0.0
BMW,318I,2007,1,0,0.0,1,100.0,0,0.0
BMW,318I SE,2007,1,1,100.0,0,0.0,0,0.0
BMW,318I SE,2008,46,29,63.0,17,37.0,0,0.0
BMW,318I SE,2009,6,4,66.7,2,33.3,0,0.0
BMW,320,1981,4,2,50.0,2,50.0,0,0.0
BMW,320,1983,2,2,100.0,0,0.0,0,0.0
BMW,320,1984,1,0,0.0,1,100.0,0,0.0
BMW,320,1986,1,0,0.0,1,100.0,0,0.0
BMW,320,1987,3,1,33.3,2,66.7,0,0.0
BMW,320,1988,9,1,11.1,8,88.9,0,0.0
BMW,320,1989,11,2,18.2,9,81.8,0,0.0
BMW,320,1990,16,6,37.5,10,62.5,0,0.0
BMW,320,1991,6,3,50.0,3,50.0,0,0.0
BMW,320,1992,5,0,0.0,5,100.0,0,0.0
BMW,320,1993,1,0,0.0,1,100.0,0,0.0
BMW,320,1994,2,0,0.0,2,100.0,0,0.0
BMW,320,1995,1,0,0.0,1,100.0,0,0.0
BMW,320,1996,3,1,33.3,2,66.7,0,0.0
BMW,320,1997,1,0,0.0,1,100.0,0,0.0
BMW,320,1999,2,0,0.0,2,100.0,0,0.0
BMW,320,2000,15,2,13.3,13,86.7,0,0.0
BMW,320,2001,81,19,23.5,62,76.5,0,0.0
BMW,320,2002,169,40,23.7,129,76.3,0,0.0
BMW,320,2003,452,121,26.8,331,73.2,0,0.0
BMW,320,2004,1054,255,24.2,799,75.8,0,0.0
BMW,320,2005,1890,627,33.2,1263,66.8,0,0.0
BMW,320,2006,1596,653,40.9,943,59.1,1,0.1
BMW,320,2007,1384,647,46.7,737,53.3,2,0.1
BMW,320,2008,1955,927,47.4,1028,52.6,1,0.1
BMW,320,2009,384,160,41.7,224,58.3,0,0.0
BMW,320,2010,814,438,53.8,376,46.2,0,0.0
BMW,320,2011,347,214,61.7,133,38.3,0,0.0
BMW,320,2012,898,620,69.0,278,31.0,0,0.0
BMW,320,2013,313,224,71.6,89,28.4,0,0.0
BMW,320,2014,595,461,77.5,134,22.5,0,0.0
BMW,320,2015,20,17,85.0,3,15.0,0,0.0
BMW,320,2016,2,1,50.0,1,50.0,0,0.0
BMW,320 (E46) SE 150BHP,2005,2,0,0.0,2,100.0,0,0.0
BMW,320 (E90) D 163BHP 4DR,2006,1,0,0.0,1,100.0,0,0.0
BMW,320 (E90) I 4DR,2006,1,1,100.0,0,0.0,0,0.0
BMW,320 (E90) I SE 4DR A,2007,1,1,100.0,0,0.0,0,0.0
BMW,320 D E46 SE 150BHP,2004,1,0,0.0,1,100.0,0,0.0
BMW,320 D E92 SE 2DR,2007,1,1,100.0,0,0.0,0,0.0
BMW,320D SE 150 BHP,2002,1,0,0.0,1,100.0,0,0.0
BMW,325,1985,1,0,0.0,1,100.0,0,0.0
BMW,325,1986,2,1,50.0,1,50.0,0,0.0
BMW,325,1987,7,2,28.6,5,71.4,0,0.0
BMW,325,1988,8,1,12.5,7,87.5,0,0.0
BMW,325,1989,6,3,50.0,3,50.0,0,0.0
BMW,325,1990,18,9,50.0,9,50.0,0,0.0
BMW,325,1991,6,2,33.3,4,66.7,0,0.0
BMW,325,1992,2,1,50.0,1,50.0,0,0.0
BMW,325,1993,4,2,50.0,2,50.0,0,0.0
BMW,325,1994,1,1,100.0,0,0.0,0,0.0
BMW,325,1995,1,0,0.0,1,100.0,0,0.0
BMW,325,2001,12,3,25.0,9,75.0,0,0.0
BMW,325,2002,19,7,36.8,12,63.2,0,0.0
BMW,325,2003,28,15,53.6,13,46.4,0,0.0
BMW,325,2004,43,22,51.2,21,48.8,0,0.0
BMW,325,2005,55,31,56.4,24,43.6,0,0.0
BMW,325,2006,74,46,62.2,28,37.8,0,0.0
BMW,325,2007,220,130,59.1,90,40.9,0,0.0
BMW,325,2008,49,26,53.1,23,46.9,0,0.0
BMW,325,2009,17,12,70.6,5,29.4,0,0.0
BMW,325,2010,11,4,36.4,7,63.6,0,0.0
BMW,325,2011,5,2,40.0,3,60.0,0,0.0
BMW,325,2012,2,2,100.0,0,0.0,0,0.0
BMW,325,2013,1,1,100.0,0,0.0,0,0.0
BMW,325,2014,10,8,80.0,2,20.0,0,0.0
BMW,325 I SPORT,2007,2,2,100.0,0,0.0,0,0.0
BMW,328,1996,2,1,50.0,1,50.0,0,0.0
BMW,328,1997,2,0,0.0,2,100.0,0,0.0
BMW,328,1998,3,0,0.0,3,100.0,0,0.0
BMW,328,1999,4,3,75.0,1,25.0,0,0.0
BMW,328,2012,6,6,100.0,0,0.0,0,0.0
BMW,328,2013,1,0,0.0,1,100.0,0,0.0
BMW,330,2001,7,4,57.1,3,42.9,0,0.0
BMW,330,2002,11,7,63.6,4,36.4,0,0.0
BMW,330,2003,13,2,15.4,11,84.6,0,0.0
BMW,330,2004,21,10,47.6,11,52.4,0,0.0
BMW,330,2005,22,8,36.4,14,63.6,0,0.0
BMW,330,2006,33,17,51.5,16,48.5,0,0.0
BMW,330,2007,34,18,52.9,16,47.1,0,0.0
BMW,330,2008,20,10,50.0,10,50.0,0,0.0
BMW,330,2009,15,10,66.7,5,33.3,0,0.0
BMW,330,2010,13,8,61.5,5,38.5,0,0.0
BMW,330,2011,1,1,100.0,0,0.0,0,0.0
BMW,330,2012,9,8,88.9,1,11.1,0,0.0
BMW,330,2013,26,22,84.6,4,15.4,0,0.0
BMW,330,2014,52,38,73.1,14,26.9,0,0.0
BMW,330,2015,3,3,100.0,0,0.0,0,0.0
BMW,330 D E46 SPORT TOURING 5DR A,2002,1,1,100.0,0,0.0,0,0.0
BMW,335,2003,1,1,100.0,0,0.0,0,0.0
BMW,335,2006,19,11,57.9,8,42.1,0,0.0
BMW,335,2007,76,37,48.7,39,51.3,0,0.0
BMW,335,2008,27,18,66.7,9,33.3,0,0.0
BMW,335,2009,9,6,66.7,3,33.3,0,0.0
BMW,335,2010,3,1,33.3,2,66.7,0,0.0
BMW,335,2011,1,0,0.0,1,100.0,0,0.0
BMW,335,2013,2,1,50.0,1,50.0,0,0.0
BMW,335,2014,11,10,90.9,1,9.1,0,0.0
BMW,335I,2007,2,0,0.0,2,100.0,0,0.0
BMW,335I,2008,3,1,33.3,2,66.7,0,0.0
BMW,335I,2014,1,1,100.0,0,0.0,0,0.0
BMW,418,2014,27,25,92.6,2,7.4,0,0.0
BMW,418,2015,2,2,100.0,0,0.0,0,0.0
BMW,420,2013,8,7,87.5,1,12.5,0,0.0
BMW,420,2014,387,319,82.4,68,17.6,0,0.0
BMW,420,2015,29,26,89.7,3,10.3,0,0.0
BMW,425,2014,6,5,83.3,1,16.7,0,0.0
BMW,428,2014,6,5,83.3,1,16.7,0,0.0
BMW,430,2013,1,1,100.0,0,0.0,0,0.0
BMW,430,2014,34,30,88.2,4,11.8,0,0.0
BMW,430,2015,6,6,100.0,0,0.0,0,0.0
BMW,435,2014,19,15,78.9,4,21.1,0,0.0
BMW,435,2015,1,1,100.0,0,0.0,0,0.0
BMW,518,2013,36,29,80.6,7,19.4,0,0.0
BMW,518,2014,531,435,81.9,96,18.1,0,0.0
BMW,518,2015,35,31,88.6,4,11.4,0,0.0
BMW,518,2016,3,3,100.0,0,0.0,0,0.0
BMW,520,1986,2,2,100.0,0,0.0,0,0.0
BMW,520,1988,3,1,33.3,2,66.7,0,0.0
BMW,520,1989,1,1,100.0,0,0.0,0,0.0
BMW,520,1990,4,3,75.0,1,25.0,0,0.0
BMW,520,1991,2,0,0.0,2,100.0,0,0.0
BMW,520,1992,6,2,33.3,4,66.7,0,0.0
BMW,520,1993,3,1,33.3,2,66.7,0,0.0
BMW,520,1994,10,0,0.0,10,100.0,0,0.0
BMW,520,1995,13,4,30.8,9,69.2,0,0.0
BMW,520,1996,5,1,20.0,4,80.0,0,0.0
BMW,520,1997,8,1,12.5,7,87.5,0,0.0
BMW,520,1998,16,4,25.0,12,75.0,0,0.0
BMW,520,1999,31,8,25.8,23,74.2,0,0.0
BMW,520,2000,92,27,29.3,65,70.7,0,0.0
BMW,520,2001,69,23,33.3,46,66.7,0,0.0
BMW,520,2002,123,41,33.3,82,66.7,0,0.0
BMW,520,2003,153,57,37.3,96,62.7,0,0.0
BMW,520,2004,384,127,33.1,257,66.9,0,0.0
BMW,520,2005,434,140,32.3,294,67.7,0,0.0
BMW,520,2006,1600,525,32.8,1075,67.2,1,0.1
BMW,520,2007,1884,736,39.1,1148,60.9,0,0.0
BMW,520,2008,3106,1494,48.1,1612,51.9,1,0.0
BMW,520,2009,789,416,52.7,373,47.3,0,0.0
BMW,520,2010,1703,1049,61.6,654,38.4,1,0.1
BMW,520,2011,740,429,58.0,311,42.0,0,0.0
BMW,520,2012,2544,1851,72.8,693,27.2,1,0.0
BMW,520,2013,563,434,77.1,129,22.9,0,0.0
BMW,520,2014,1984,1629,82.1,355,17.9,0,0.0
BMW,520,2015,130,119,91.5,11,8.5,0,0.0
BMW,520,2016,3,1,33.3,2,66.7,0,0.0
BMW,520,2017,5,5,100.0,0,0.0,0,0.0
BMW,520,2018,2,2,100.0,0,0.0,0,0.0
BMW,520 D E60 M SPORT 4DR,2007,1,0,0.0,1,100.0,0,0.0
BMW,520 D E60 M SPORT 4DR,2008,1,0,0.0,1,100.0,0,0.0
BMW,520 D E60 SE 4DR,2007,1,0,0.0,1,100.0,0,0.0
BMW,520 D E60 SPORT 04DR,2006,1,0,0.0,1,100.0,0,0.0
BMW,523,1996,1,0,0.0,1,100.0,0,0.0
BMW,523,1998,3,1,33.3,2,66.7,0,0.0
BMW,523,1999,2,1,50.0,1,50.0,0,0.0
BMW,523,2005,164,64,39.0,100,61.0,0,0.0
BMW,523,2006,225,101,44.9,124,55.1,0,0.0
BMW,523,2007,140,82,58.6,58,41.4,0,0.0
BMW,523,2008,26,15,57.7,11,42.3,0,0.0
BMW,523,2010,2,2,100.0,0,0.0,0,0.0
BMW,523,2011,1,1,100.0,0,0.0,0,0.0
BMW,525,1980,1,0,0.0,1,100.0,0,0.0
BMW,525,1986,1,0,0.0,1,100.0,0,0.0
BMW,525,1987,1,0,0.0,1,100.0,0,0.0
BMW,525,1988,2,1,50.0,1,50.0,0,0.0
BMW,525,1991,1,1,100.0,0,0.0,0,0.0
BMW,525,1993,2,0,0.0,2,100.0,0,0.0
BMW,525,1994,5,1,20.0,4,80.0,0,0.0
BMW,525,1995,6,0,0.0,6,100.0,0,0.0
BMW,525,1997,2,1,50.0,1,50.0,0,0.0
BMW,525,1998,2,1,50.0,1,50.0,0,0.0
BMW,525,2001,13,4,30.8,9,69.2,0,0.0
BMW,525,2002,47,8,17.0,39,83.0,0,0.0
BMW,525,2003,58,15,25.9,43,74.1,0,0.0
BMW,525,2004,107,27,25.2,80,74.8,0,0.0
BMW,525,2005,266,91,34.2,175,65.8,0,0.0
BMW,525,2006,153,65,42.5,88,57.5,0,0.0
BMW,525,2007,78,36,46.2,42,53.8,0,0.0
BMW,525,2008,38,23,60.5,15,39.5,0,0.0
BMW,525,2009,7,4,57.1,3,42.9,0,0.0
BMW,525,2010,131,91,69.5,40,30.5,0,0.0
BMW,525,2011,14,8,57.1,6,42.9,0,0.0
BMW,525,2012,49,30,61.2,19,38.8,0,0.0
BMW,525,2013,5,3,60.0,2,40.0,0,0.0
BMW,525,2014,26,20,76.9,6,23.1,0,0.0
BMW,525,2015,3,3,100.0,0,0.0,0,0.0
BMW,525I SPORT,2002,1,1,100.0,0,0.0,0,0.0
BMW,528,1983,1,1,100.0,0,0.0,0,0.0
BMW,528,1984,2,0,0.0,2,100.0,0,0.0
BMW,528,1998,2,0,0.0,2,100.0,0,0.0
BMW,528,1999,2,2,100.0,0,0.0,0,0.0
BMW,528,2000,3,2,66.7,1,33.3,0,0.0
BMW,528,2001,2,0,0.0,2,100.0,0,0.0
BMW,528,2010,1,0,0.0,1,100.0,0,0.0
BMW,528,2011,1,1,100.0,0,0.0,0,0.0
BMW,528,2014,1,1,100.0,0,0.0,0,0.0
BMW,528,2015,1,1,100.0,0,0.0,0,0.0
BMW,530,1993,2,1,50.0,1,50.0,0,0.0
BMW,530,2000,3,0,0.0,3,100.0,0,0.0
BMW,530,2001,14,4,28.6,10,71.4,0,0.0
BMW,530,2002,27,8,29.6,19,70.4,0,0.0
BMW,530,2003,29,11,37.9,18,62.1,0,0.0
BMW,530,2004,54,15,27.8,39,72.2,0,0.0
BMW,530,2005,86,31,36.0,55,64.0,0,0.0
BMW,530,2006,130,56,43.1,74,56.9,0,0.0
BMW,530,2007,101,52,51.5,49,48.5,0,0.0
BMW,530,2008,47,25,53.2,22,46.8,0,0.0
BMW,530,2009,15,11,73.3,4,26.7,0,0.0
BMW,530,2010,123,66,53.7,57,46.3,0,0.0
BMW,530,2011,22,17,77.3,5,22.7,0,0.0
BMW,530,2012,34,25,73.5,9,26.5,0,0.0
BMW,530,2013,14,7,50.0,7,50.0,0,0.0
BMW,530,2014,49,42,85.7,7,14.3,0,0.0
BMW,530,2015,3,3,100.0,0,0.0,0,0.0
BMW,530,2016,1,1,100.0,0,0.0,0,0.0
BMW,530,2017,1,1,100.0,0,0.0,0,0.0
BMW,530E (HYBRID),2017,1,0,0.0,1,100.0,1,100.0
BMW,535,1986,1,0,0.0,1,100.0,0,0.0
BMW,535,1987,2,1,50.0,1,50.0,0,0.0
BMW,535,1989,2,1,50.0,1,50.0,0,0.0
BMW,535,1990,3,1,33.3,2,66.7,0,0.0
BMW,535,1998,1,0,0.0,1,100.0,0,0.0
BMW,535,2000,1,1,100.0,0,0.0,0,0.0
BMW,535,2001,1,1,100.0,0,0.0,0,0.0
BMW,535,2004,1,1,100.0,0,0.0,0,0.0
BMW,535,2005,59,19,32.2,40,67.8,0,0.0
BMW,535,2006,47,18,38.3,29,61.7,0,0.0
BMW,535,2007,48,20,41.7,28,58.3,0,0.0
BMW,535,2008,31,19,61.3,12,38.7,0,0.0
BMW,535,2009,8,3,37.5,5,62.5,0,0.0
BMW,535,2010,3,2,66.7,1,33.3,0,0.0
BMW,535,2011,12,7,58.3,5,41.7,0,0.0
BMW,535,2012,21,18,85.7,3,14.3,0,0.0
BMW,535,2013,4,0,0.0,4,100.0,0,0.0
BMW,535,2014,25,21,84.0,4,16.0,0,0.0
BMW,540,2003,1,1,100.0,0,0.0,0,0.0
BMW,550,2002,1,0,0.0,1,100.0,0,0.0
BMW,550,2007,1,1,100.0,0,0.0,0,0.0
BMW,630,2005,92,49,53.3,43,46.7,0,0.0
BMW,630,2006,104,58,55.8,46,44.2,0,0.0
BMW,630,2007,84,56,66.7,28,33.3,0,0.0
BMW,630,2008,13,10,76.9,3,23.1,0,0.0
BMW,630,2009,3,2,66.7,1,33.3,0,0.0
BMW,630,2010,1,1,100.0,0,0.0,0,0.0
BMW,635,1983,1,1,100.0,0,0.0,0,0.0
BMW,635,1984,2,2,100.0,0,0.0,0,0.0
BMW,635,1985,2,1,50.0,1,50.0,0,0.0
BMW,635,1986,1,1,100.0,0,0.0,0,0.0
BMW,635,1987,2,2,100.0,0,0.0,0,0.0
BMW,635,1988,2,1,50.0,1,50.0,0,0.0
BMW,635,2007,1,1,100.0,0,0.0,0,0.0
BMW,635,2008,23,10,43.5,13,56.5,0,0.0
BMW,635,2009,12,5,41.7,7,58.3,0,0.0
BMW,635,2010,7,4,57.1,3,42.9,0,0.0
BMW,640,2011,6,2,33.3,4,66.7,0,0.0
BMW,640,2012,96,65,67.7,31,32.3,0,0.0
BMW,640,2013,45,33,73.3,12,26.7,0,0.0
BMW,640,2014,114,89,78.1,25,21.9,0,0.0
BMW,640,2015,6,4,66.7,2,33.3,0,0.0
BMW,640,2017,1,0,0.0,1,100.0,0,0.0
BMW,645,2004,43,14,32.6,29,67.4,0,0.0
BMW,645,2005,25,13,52.0,12,48.0,0,0.0
BMW,645,2006,2,2,100.0,0,0.0,0,0.0
BMW,650,2006,11,9,81.8,2,18.2,0,0.0
BMW,650,2007,4,2,50.0,2,50.0,0,0.0
BMW,650,2008,1,1,100.0,0,0.0,0,0.0
BMW,650 I SPORT 2DR,2006,1,1,100.0,0,0.0,0,0.0
BMW,728,2000,1,1,100.0,0,0.0,0,0.0
BMW,728,2001,4,1,25.0,3,75.0,0,0.0
BMW,730,1988,1,1,100.0,0,0.0,0,0.0
BMW,730,1990,2,1,50.0,1,50.0,0,0.0
BMW,730,2003,5,2,40.0,3,60.0,0,0.0
BMW,730,2004,13,4,30.8,9,69.2,0,0.0
BMW,730,2005,60,13,21.7,47,78.3,0,0.0
BMW,730,2006,109,48,44.0,61,56.0,0,0.0
BMW,730,2007,134,48,35.8,86,64.2,0,0.0
BMW,730,2008,36,14,38.9,22,61.1,0,0.0
BMW,730,2009,15,9,60.0,6,40.0,0,0.0
BMW,730,2010,71,34,47.9,37,52.1,0,0.0
BMW,730,2011,24,14,58.3,10,41.7,0,0.0
BMW,730,2012,39,27,69.2,12,30.8,0,0.0
BMW,730,2013,21,11,52.4,10,47.6,0,0.0
BMW,730,2014,62,36,58.1,26,41.9,0,0.0
BMW,730,2015,11,9,81.8,2,18.2,0,0.0
BMW,730,2016,9,6,66.7,3,33.3,0,0.0
BMW,730,2017,10,8,80.0,2,20.0,0,0.0
BMW,730,2018,1,1,100.0,0,0.0,0,0.0
BMW,735,1988,2,0,0.0,2,100.0,0,0.0
BMW,740,1999,1,1,100.0,0,0.0,0,0.0
BMW,740,2000,2,1,50.0,1,50.0,0,0.0
BMW,740,2005,6,3,50.0,3,50.0,0,0.0
BMW,740,2006,8,4,50.0,4,50.0,0,0.0
BMW,740,2007,2,1,50.0,1,50.0,0,0.0
BMW,740,2009,2,0,0.0,2,100.0,0,0.0
BMW,740,2010,5,4,80.0,1,20.0,0,0.0
BMW,740,2011,2,1,50.0,1,50.0,0,0.0
BMW,740,2012,5,3,60.0,2,40.0,0,0.0
BMW,740,2013,1,1,100.0,0,0.0,0,0.0
BMW,740,2014,2,2,100.0,0,0.0,0,0.0
BMW,740,2015,1,0,0.0,1,100.0,0,0.0
BMW,745,2002,1,0,0.0,1,100.0,0,0.0
BMW,745,2004,1,0,0.0,1,100.0,0,0.0
BMW,750,2005,9,6,66.7,3,33.3,0,0.0
BMW,750,2006,6,4,66.7,2,33.3,0,0.0
BMW,750,2007,3,0,0.0,3,100.0,0,0.0
BMW,750 I E65 4DR A,2005,2,0,0.0,2,100.0,0,0.0
BMW,760,1988,1,0,0.0,1,100.0,0,0.0
BMW,760,1996,1,0,0.0,1,100.0,0,0.0
BMW,760,1998,1,1,100.0,0,0.0,0,0.0
BMW,760,2005,3,3,100.0,0,0.0,0,0.0
BMW,760,2006,2,2,100.0,0,0.0,0,0.0
BMW,840,1997,1,0,0.0,1,100.0,0,0.0
BMW,840,1998,2,0,0.0,2,100.0,0,0.0
BMW,I3,2013,1,1,100.0,0,0.0,0,0.0
BMW,I3,2014,24,16,66.7,8,33.3,1,4.2
BMW,I3,2015,5,5,100.0,0,0.0,0,0.0
BMW,I3 REX,2014,9,7,77.8,2,22.2,0,0.0
BMW,M135,2012,1,1,100.0,0,0.0,0,0.0
BMW,M135,2013,2,2,100.0,0,0.0,0,0.0
BMW,M135,2014,2,2,100.0,0,0.0,0,0.0
BMW,M235,2014,4,2,50.0,2,50.0,0,0.0
BMW,M3,1986,3,3,100.0,0,0.0,0,0.0
BMW,M3,1987,4,3,75.0,1,25.0,0,0.0
BMW,M3,1988,2,2,100.0,0,0.0,0,0.0
BMW,M3,1990,2,2,100.0,0,0.0,0,0.0
BMW,M3,1991,1,0,0.0,1,100.0,0,0.0
BMW,M3,1993,1,1,100.0,0,0.0,0,0.0
BMW,M3,1994,2,0,0.0,2,100.0,0,0.0
BMW,M3,1996,6,2,33.3,4,66.7,0,0.0
BMW,M3,1997,2,0,0.0,2,100.0,0,0.0
BMW,M3,1998,3,0,0.0,3,100.0,0,0.0
BMW,M3,1999,2,1,50.0,1,50.0,0,0.0
BMW,M3,2001,13,5,38.5,8,61.5,0,0.0
BMW,M3,2002,22,9,40.9,13,59.1,0,0.0
BMW,M3,2003,39,14,35.9,25,64.1,0,0.0
BMW,M3,2004,21,8,38.1,13,61.9,0,0.0
BMW,M3,2005,14,6,42.9,8,57.1,0,0.0
BMW,M3,2006,5,4,80.0,1,20.0,0,0.0
BMW,M3,2007,7,4,57.1,3,42.9,0,0.0
BMW,M3,2008,28,18,64.3,10,35.7,0,0.0
BMW,M3,2009,2,2,100.0,0,0.0,0,0.0
BMW,M3,2011,1,1,100.0,0,0.0,0,0.0
BMW,M3,2012,1,1,100.0,0,0.0,0,0.0
BMW,M3,2013,1,1,100.0,0,0.0,0,0.0
BMW,M4,2014,8,7,87.5,1,12.5,0,0.0
BMW,M5,1987,2,1,50.0,1,50.0,0,0.0
BMW,M5,1990,2,2,100.0,0,0.0,0,0.0
BMW,M5,1999,1,1,100.0,0,0.0,0,0.0
BMW,M5,2000,2,1,50.0,1,50.0,0,0.0
BMW,M5,2001,3,2,66.7,1,33.3,0,0.0
BMW,M5,2002,4,2,50.0,2,50.0,0,0.0
BMW,M5,2005,12,8,66.7,4,33.3,0,0.0
BMW,M5,2006,19,11,57.9,8,42.1,0,0.0
BMW,M5,2007,12,6,50.0,6,50.0,0,0.0
BMW,M5,2008,3,2,66.7,1,33.3,0,0.0
BMW,M5,2011,1,1,100.0,0,0.0,0,0.0
BMW,M5,2012,3,1,33.3,2,66.7,0,0.0
BMW,M5,2013,1,1,100.0,0,0.0,0,0.0
BMW,M5,2014,3,3,100.0,0,0.0,0,0.0
BMW,M6,2006,10,5,50.0,5,50.0,0,0.0
BMW,M6,2007,5,5,100.0,0,0.0,0,0.0
BMW,M6,2012,2,2,100.0,0,0.0,0,0.0
BMW,M6,2014,1,1,100.0,0,0.0,0,0.0
BMW,OTHER,1980,1,0,0.0,1,100.0,0,0.0
BMW,OTHER,1981,4,2,50.0,2,50.0,0,0.0
BMW,OTHER,1982,3,2,66.7,1,33.3,0,0.0
BMW,OTHER,1983,2,0,0.0,2,100.0,0,0.0
BMW,OTHER,1984,3,0,0.0,3,100.0,0,0.0
BMW,OTHER,1985,7,1,14.3,6,85.7,0,0.0
BMW,OTHER,1986,8,2,25.0,6,75.0,0,0.0
BMW,OTHER,1987,15,0,0.0,15,100.0,0,0.0
BMW,OTHER,1988,37,7,18.9,30,81.1,0,0.0
BMW,OTHER,1989,32,10,31.3,22,68.8,0,0.0
BMW,OTHER,1990,66,24,36.4,42,63.6,0,0.0
BMW,OTHER,1991,45,12,26.7,33,73.3,0,0.0
BMW,OTHER,1992,20,5,25.0,15,75.0,0,0.0
BMW,OTHER,1993,24,11,45.8,13,54.2,0,0.0
BMW,OTHER,1994,41,13,31.7,28,68.3,0,0.0
BMW,OTHER,1995,59,13,22.0,46,78.0,0,0.0
BMW,OTHER,1996,86,24,27.9,62,72.1,0,0.0
BMW,OTHER,1997,121,43,35.5,78,64.5,0,0.0
BMW,OTHER,1998,187,49,26.2,138,73.8,1,0.5
BMW,OTHER,1999,216,65,30.1,151,69.9,0,0.0
BMW,OTHER,2000,331,120,36.3,211,63.7,0,0.0
BMW,OTHER,2001,428,160,37.4,268,62.6,0,0.0
BMW,OTHER,2002,683,246,36.0,437,64.0,1,0.1
BMW,OTHER,2003,926,340,36.7,586,63.3,0,0.0
BMW,OTHER,2004,659,233,35.4,426,64.6,0,0.0
BMW,OTHER,2005,276,111,40.2,165,59.8,0,0.0
BMW,OTHER,2006,7,3,42.9,4,57.1,0,0.0
BMW,OTHER,2007,1,0,0.0,1,100.0,0,0.0
BMW,OTHER,2008,6,4,66.7,2,33.3,0,0.0
BMW,OTHER,2009,5,2,40.0,3,60.0,0,0.0
BMW,OTHER,2010,29,19,65.5,10,34.5,0,0.0
BMW,OTHER,2011,3,3,100.0,0,0.0,0,0.0
BMW,OTHER,2012,6,6,100.0,0,0.0,0,0.0
BMW,OTHER,2014,2,0,0.0,2,100.0,1,50.0
BMW,X1,2009,1,1,100.0,0,0.0,0,0.0
BMW,X1,2010,264,185,70.1,79,29.9,0,0.0
BMW,X1,2011,41,36,87.8,5,12.2,0,0.0
BMW,X1,2012,134,99,73.9,35,26.1,0,0.0
BMW,X1,2013,22,21,95.5,1,4.5,0,0.0
BMW,X1,2014,164,147,89.6,17,10.4,0,0.0
BMW,X1,2015,5,5,100.0,0,0.0,0,0.0
BMW,X1,2016,1,1,100.0,0,0.0,0,0.0
BMW,X3,2004,55,30,54.5,25,45.5,0,0.0
BMW,X3,2005,309,158,51.1,151,48.9,0,0.0
BMW,X3,2006,162,88,54.3,74,45.7,0,0.0
BMW,X3,2007,132,58,43.9,74,56.1,2,1.5
BMW,X3,2008,51,23,45.1,28,54.9,0,0.0
BMW,X3,2009,6,5,83.3,1,16.7,0,0.0
BMW,X3,2010,16,11,68.8,5,31.3,0,0.0
BMW,X3,2011,20,17,85.0,3,15.0,0,0.0
BMW,X3,2012,204,158,77.5,46,22.5,2,1.0
BMW,X3,2013,33,25,75.8,8,24.2,0,0.0
BMW,X3,2014,199,175,87.9,24,12.1,1,0.5
BMW,X3,2015,20,19,95.0,1,5.0,0,0.0
BMW,X3 2.0D SE 5DR,2008,1,1,100.0,0,0.0,0,0.0
BMW,X4,2014,24,20,83.3,4,16.7,0,0.0
BMW,X4,2015,16,14,87.5,2,12.5,0,0.0
BMW,X5,2001,2,1,50.0,1,50.0,0,0.0
BMW,X5,2002,8,2,25.0,6,75.0,0,0.0
BMW,X5,2003,38,12,31.6,26,68.4,0,0.0
BMW,X5,2004,104,28,26.9,76,73.1,0,0.0
BMW,X5,2005,272,83,30.5,189,69.5,1,0.4
BMW,X5,2006,259,84,32.4,175,67.6,0,0.0
BMW,X5,2007,240,112,46.7,128,53.3,1,0.4
BMW,X5,2008,234,119,50.9,115,49.1,1,0.4
BMW,X5,2009,31,22,71.0,9,29.0,0,0.0
BMW,X5,2010,46,28,60.9,18,39.1,0,0.0
BMW,X5,2011,16,10,62.5,6,37.5,0,0.0
BMW,X5,2012,52,34,65.4,18,34.6,0,0.0
BMW,X5,2013,17,14,82.4,3,17.6,0,0.0
BMW,X5,2014,264,208,78.8,56,21.2,0,0.0
BMW,X5,2015,40,36,90.0,4,10.0,0,0.0
BMW,X5,2016,2,1,50.0,1,50.0,0,0.0
BMW,X5 E53 3.0D SPORT 5DR,2006,2,1,50.0,1,50.0,0,0.0
BMW,X5 SPORT,2005,1,0,0.0,1,100.0,0,0.0
BMW,X53,2004,2,0,0.0,2,100.0,0,0.0
BMW,X53,2005,3,0,0.0,3,100.0,0,0.0
BMW,X6,2008,42,23,54.8,19,45.2,0,0.0
BMW,X6,2009,5,2,40.0,3,60.0,0,0.0
BMW,X6,2010,3,1,33.3,2,66.7,0,0.0
BMW,X6,2011,1,1,100.0,0,0.0,0,0.0
BMW,X6,2012,3,3,100.0,0,0.0,0,0.0
BMW,X6,2013,2,2,100.0,0,0.0,0,0.0
BMW,X6,2014,6,4,66.7,2,33.3,0,0.0
BMW,X6,2015,6,5,83.3,1,16.7,0,0.0
BMW,Z3,1996,1,0,0.0,1,100.0,0,0.0
BMW,Z3,1997,18,6,33.3,12,66.7,0,0.0
BMW,Z3,1998,23,9,39.1,14,60.9,0,0.0
BMW,Z3,1999,21,8,38.1,13,61.9,0,0.0
BMW,Z3,2000,45,18,40.0,27,60.0,0,0.0
BMW,Z3,2001,37,24,64.9,13,35.1,0,0.0
BMW,Z3,2002,25,7,28.0,18,72.0,0,0.0
BMW,Z3,2003,1,1,100.0,0,0.0,0,0.0
BMW,Z4,2003,16,7,43.8,9,56.3,0,0.0
BMW,Z4,2004,52,33,63.5,19,36.5,0,0.0
BMW,Z4,2005,64,31,48.4,33,51.6,0,0.0
BMW,Z4,2006,53,31,58.5,22,41.5,0,0.0
BMW,Z4,2007,36,21,58.3,15,41.7,0,0.0
BMW,Z4,2008,7,5,71.4,2,28.6,0,0.0
BMW,Z4,2010,8,7,87.5,1,12.5,0,0.0
BMW,Z4,2011,2,1,50.0,1,50.0,0,0.0
BMW,Z4,2012,8,6,75.0,2,25.0,0,0.0
BMW,Z4,2013,3,3,100.0,0,0.0,0,0.0
BMW,Z4,2014,14,12,85.7,2,14.3,0,0.0
BMW,Z8,2001,1,1,100.0,0,0.0,0,0.0
BRAMWITH,OTHER,2004,2,1,50.0,1,50.0,0,0.0
BRANFORD,ELITE,2012,3,0,0.0,3,100.0,0,0.0
BRENCHLEY,OTHER,1995,2,2,100.0,0,0.0,0,0.0
BRENCHLEY,OTHER,1997,2,0,0.0,2,100.0,0,0.0
BRENCHLEY,OTHER,2010,1,1,100.0,0,0.0,0,0.0
BRISTOL,BLENHEIM 2DR A,2000,2,0,0.0,2,100.0,0,0.0
BRISTOL,OTHER,2000,1,0,0.0,1,100.0,0,0.0
CADILLAC,BLS,2006,8,2,25.0,6,75.0,0,0.0
CADILLAC,BLS,2007,2,2,100.0,0,0.0,0,0.0
CADILLAC,OTHER,1993,2,1,50.0,1,50.0,0,0.0
CADILLAC,OTHER,2004,1,1,100.0,0,0.0,0,0.0
CARBODIES,FAIRWAY,1991,5,2,40.0,3,60.0,0,0.0
CARBODIES,FAIRWAY,1997,1,0,0.0,1,100.0,0,0.0
CATERHAM,OTHER,2003,1,1,100.0,0,0.0,0,0.0
CATERHAM,SUPER SEVEN,2010,1,1,100.0,0,0.0,0,0.0
CHEVROLET,AVEO,2004,1,0,0.0,1,100.0,0,0.0
CHEVROLET,AVEO,2006,149,52,34.9,97,65.1,0,0.0
CHEVROLET,AVEO,2007,366,139,38.0,227,62.0,0,0.0
CHEVROLET,AVEO,2008,248,84,33.9,164,66.1,0,0.0
CHEVROLET,AVEO,2009,44,24,54.5,20,45.5,0,0.0
CHEVROLET,AVEO,2010,291,146,50.2,145,49.8,0,0.0
CHEVROLET,AVEO,2011,66,33,50.0,33,50.0,0,0.0
CHEVROLET,AVEO,2012,17,10,58.8,7,41.2,0,0.0
CHEVROLET,AVEO,2013,3,0,0.0,3,100.0,0,0.0
CHEVROLET,AVEO,2014,2,2,100.0,0,0.0,0,0.0
CHEVROLET,CAMARO,1986,2,2,100.0,0,0.0,0,0.0
CHEVROLET,CAMARO,2010,1,0,0.0,1,100.0,0,0.0
CHEVROLET,CAPTIVA,2007,68,13,19.1,55,80.9,0,0.0
CHEVROLET,CAPTIVA,2008,61,17,27.9,44,72.1,0,0.0
CHEVROLET,CAPTIVA,2009,8,2,25.0,6,75.0,0,0.0
CHEVROLET,CAPTIVA,2010,32,12,37.5,20,62.5,0,0.0
CHEVROLET,CAPTIVA,2012,1,0,0.0,1,100.0,0,0.0
CHEVROLET,CAPTIVA,2014,1,1,100.0,0,0.0,0,0.0
CHEVROLET,CRUZE,2004,2,1,50.0,1,50.0,0,0.0
CHEVROLET,CRUZE,2009,3,1,33.3,2,66.7,0,0.0
CHEVROLET,CRUZE,2010,8,3,37.5,5,62.5,0,0.0
CHEVROLET,CRUZE,2011,5,2,40.0,3,60.0,0,0.0
CHEVROLET,CRUZE,2012,20,15,75.0,5,25.0,0,0.0
CHEVROLET,CRUZE,2013,2,0,0.0,2,100.0,0,0.0
CHEVROLET,CRUZE,2014,9,8,88.9,1,11.1,0,0.0
CHEVROLET,EPICA,2007,22,9,40.9,13,59.1,0,0.0
CHEVROLET,EPICA,2008,17,5,29.4,12,70.6,0,0.0
CHEVROLET,EPICA,2009,26,3,11.5,23,88.5,0,0.0
CHEVROLET,EPICA,2010,7,0,0.0,7,100.0,0,0.0
CHEVROLET,EPICA,2011,7,5,71.4,2,28.6,0,0.0
CHEVROLET,KALOS,2005,466,140,30.0,326,70.0,0,0.0
CHEVROLET,KALOS,2006,531,155,29.2,376,70.8,0,0.0
CHEVROLET,KALOS,2007,144,54,37.5,90,62.5,0,0.0
CHEVROLET,KALOS,2008,54,20,37.0,34,63.0,0,0.0
CHEVROLET,KALOS,2009,8,3,37.5,5,62.5,0,0.0
CHEVROLET,KYRON,2006,35,5,14.3,30,85.7,0,0.0
CHEVROLET,LACETTI,2005,238,65,27.3,173,72.7,0,0.0
CHEVROLET,LACETTI,2006,340,105,30.9,235,69.1,0,0.0
CHEVROLET,LACETTI,2007,291,91,31.3,200,68.7,0,0.0
CHEVROLET,LACETTI,2008,63,23,36.5,40,63.5,0,0.0
CHEVROLET,LACETTI,2009,24,6,25.0,18,75.0,0,0.0
CHEVROLET,LACETTI,2010,2,1,50.0,1,50.0,0,0.0
CHEVROLET,LACETTI,2011,1,1,100.0,0,0.0,0,0.0
CHEVROLET,MATIZ,2005,106,38,35.8,68,64.2,0,0.0
CHEVROLET,MATIZ,2006,106,42,39.6,64,60.4,0,0.0
CHEVROLET,MATIZ,2007,105,40,38.1,65,61.9,0,0.0
CHEVROLET,MATIZ,2008,36,11,30.6,25,69.4,0,0.0
CHEVROLET,MATIZ,2009,9,2,22.2,7,77.8,0,0.0
CHEVROLET,MATIZ,2010,3,2,66.7,1,33.3,0,0.0
CHEVROLET,NUBIRA,2005,91,32,35.2,59,64.8,0,0.0
CHEVROLET,NUBIRA,2006,1,0,0.0,1,100.0,0,0.0
CHEVROLET,ORLANDO,2011,2,0,0.0,2,100.0,0,0.0
CHEVROLET,ORLANDO,2012,2,1,50.0,1,50.0,0,0.0
CHEVROLET,ORLANDO,2013,1,0,0.0,1,100.0,0,0.0
CHEVROLET,ORLANDO,2014,1,1,100.0,0,0.0,0,0.0
CHEVROLET,OTHER,1957,1,1,100.0,0,0.0,0,0.0
CHEVROLET,OTHER,1981,1,0,0.0,1,100.0,0,0.0
CHEVROLET,OTHER,1986,1,0,0.0,1,100.0,0,0.0
CHEVROLET,OTHER,1987,1,0,0.0,1,100.0,0,0.0
CHEVROLET,OTHER,1992,1,1,100.0,0,0.0,0,0.0
CHEVROLET,OTHER,1995,2,0,0.0,2,100.0,0,0.0
CHEVROLET,OTHER,2000,1,0,0.0,1,100.0,1,100.0
CHEVROLET,OTHER,2002,2,1,50.0,1,50.0,0,0.0
CHEVROLET,OTHER,2003,1,1,100.0,0,0.0,0,0.0
CHEVROLET,OTHER,2007,1,0,0.0,1,100.0,0,0.0
CHEVROLET,OTHER,2008,1,0,0.0,1,100.0,0,0.0
CHEVROLET,OTHER,2009,1,1,100.0,0,0.0,0,0.0
CHEVROLET,REXTON,2005,46,5,10.9,41,89.1,0,0.0
CHEVROLET,REXTON,2006,27,2,7.4,25,92.6,0,0.0
CHEVROLET,RODIUS,2005,12,1,8.3,11,91.7,0,0.0
CHEVROLET,RODIUS,2006,33,4,12.1,29,87.9,0,0.0
CHEVROLET,RODIUS,2007,8,2,25.0,6,75.0,0,0.0
CHEVROLET,SPARK,2010,11,6,54.5,5,45.5,0,0.0
CHEVROLET,SPARK,2011,11,4,36.4,7,63.6,0,0.0
CHEVROLET,SPARK,2012,31,18,58.1,13,41.9,0,0.0
CHEVROLET,SPARK,2013,3,1,33.3,2,66.7,1,33.3
CHEVROLET,SPARK,2014,5,3,60.0,2,40.0,0,0.0
CHEVROLET,TACUMA,2005,9,2,22.2,7,77.8,0,0.0
CHEVROLET,TACUMA,2006,13,5,38.5,8,61.5,0,0.0
CHEVROLET,TACUMA,2007,16,4,25.0,12,75.0,0,0.0
CHEVROLET,TACUMA,2008,4,2,50.0,2,50.0,0,0.0
CHEVROLET,TACUMA,2010,1,0,0.0,1,100.0,0,0.0
CHEVROLET,TRAX,2013,1,0,0.0,1,100.0,0,0.0
CHEVROLET,TRAX,2014,2,2,100.0,0,0.0,0,0.0
CHEVROLET,VOLT,2012,1,1,100.0,0,0.0,0,0.0
CHEVROLET,VOLT,2013,2,2,100.0,0,0.0,0,0.0
CHRYSLER,300C,2005,2,1,50.0,1,50.0,0,0.0
CHRYSLER,300C,2006,108,35,32.4,73,67.6,0,0.0
CHRYSLER,300C,2007,82,29,35.4,53,64.6,0,0.0
CHRYSLER,300C,2008,42,10,23.8,32,76.2,0,0.0
CHRYSLER,300C,2009,1,0,0.0,1,100.0,0,0.0
CHRYSLER,300C,2010,6,5,83.3,1,16.7,0,0.0
CHRYSLER,300C,2012,2,0,0.0,2,100.0,0,0.0
CHRYSLER,300C,2013,6,3,50.0,3,50.0,0,0.0
CHRYSLER,300C,2014,1,1,100.0,0,0.0,0,0.0
CHRYSLER,300C,2015,1,1,100.0,0,0.0,0,0.0
CHRYSLER,CHEROKEE,2007,2,2,100.0,0,0.0,0,0.0
CHRYSLER,CROSSFIRE,2004,8,3,37.5,5,62.5,0,0.0
CHRYSLER,CROSSFIRE,2005,3,2,66.7,1,33.3,0,0.0
CHRYSLER,DELTA,2012,34,20,58.8,14,41.2,0,0.0
CHRYSLER,DELTA,2014,1,0,0.0,1,100.0,0,0.0
CHRYSLER,GRAND VOYAGER,2002,2,0,0.0,2,100.0,0,0.0
CHRYSLER,GRAND VOYAGER,2003,7,1,14.3,6,85.7,0,0.0
CHRYSLER,GRAND VOYAGER,2004,5,1,20.0,4,80.0,0,0.0
CHRYSLER,GRAND VOYAGER,2005,33,5,15.2,28,84.8,0,0.0
CHRYSLER,GRAND VOYAGER,2006,39,15,38.5,24,61.5,0,0.0
CHRYSLER,GRAND VOYAGER,2007,30,12,40.0,18,60.0,0,0.0
CHRYSLER,GRAND VOYAGER,2008,13,5,38.5,8,61.5,0,0.0
CHRYSLER,GRAND VOYAGER,2009,3,1,33.3,2,66.7,0,0.0
CHRYSLER,GRAND VOYAGER,2010,2,1,50.0,1,50.0,0,0.0
CHRYSLER,GRAND VOYAGER,2011,7,2,28.6,5,71.4,0,0.0
CHRYSLER,GRAND VOYAGER,2012,12,2,16.7,10,83.3,0,0.0
CHRYSLER,GRAND VOYAGER,2013,2,0,0.0,2,100.0,0,0.0
CHRYSLER,GRAND VOYAGER,2014,10,7,70.0,3,30.0,0,0.0
CHRYSLER,JEEP RANGE,1993,1,0,0.0,1,100.0,0,0.0
CHRYSLER,JEEP RANGE,1995,2,0,0.0,2,100.0,0,0.0
CHRYSLER,JEEP RANGE,1997,3,1,33.3,2,66.7,0,0.0
CHRYSLER,JEEP RANGE,1998,7,3,42.9,4,57.1,0,0.0
CHRYSLER,JEEP RANGE,1999,3,1,33.3,2,66.7,0,0.0
CHRYSLER,JEEP RANGE,2000,3,0,0.0,3,100.0,0,0.0
CHRYSLER,JEEP RANGE,2001,1,0,0.0,1,100.0,0,0.0
CHRYSLER,JEEP RANGE,2002,6,0,0.0,6,100.0,0,0.0
CHRYSLER,JEEP RANGE,2003,11,2,18.2,9,81.8,0,0.0
CHRYSLER,JEEP RANGE,2004,7,4,57.1,3,42.9,0,0.0
CHRYSLER,JEEP RANGE,2005,11,2,18.2,9,81.8,1,9.1
CHRYSLER,JEEP RANGE,2006,14,2,14.3,12,85.7,0,0.0
CHRYSLER,JEEP RANGE,2007,17,4,23.5,13,76.5,0,0.0
CHRYSLER,JEEP RANGE,2008,4,0,0.0,4,100.0,0,0.0
CHRYSLER,JEEP RANGE,2009,3,0,0.0,3,100.0,0,0.0
CHRYSLER,JEEP RANGE,2010,2,2,100.0,0,0.0,0,0.0
CHRYSLER,JEEP RANGE,2011,1,0,0.0,1,100.0,0,0.0
CHRYSLER,JEEP RANGE,2012,1,0,0.0,1,100.0,0,0.0
CHRYSLER,JEEP RANGE,2013,1,0,0.0,1,100.0,0,0.0
CHRYSLER,JEEP RANGE,2014,2,0,0.0,2,100.0,0,0.0
CHRYSLER,NEON,1999,1,0,0.0,1,100.0,0,0.0
CHRYSLER,NEON,2001,3,2,66.7,1,33.3,0,0.0
CHRYSLER,NEON,2004,1,0,0.0,1,100.0,0,0.0
CHRYSLER,OTHER,1991,1,1,100.0,0,0.0,0,0.0
CHRYSLER,OTHER,2001,11,2,18.2,9,81.8,0,0.0
CHRYSLER,OTHER,2002,8,4,50.0,4,50.0,0,0.0
CHRYSLER,OTHER,2003,11,1,9.1,10,90.9,0,0.0
CHRYSLER,OTHER,2004,31,11,35.5,20,64.5,0,0.0
CHRYSLER,OTHER,2005,39,9,23.1,30,76.9,0,0.0
CHRYSLER,OTHER,2006,77,29,37.7,48,62.3,0,0.0
CHRYSLER,OTHER,2007,67,22,32.8,45,67.2,0,0.0
CHRYSLER,OTHER,2008,26,11,42.3,15,57.7,0,0.0
CHRYSLER,OTHER,2009,5,4,80.0,1,20.0,0,0.0
CHRYSLER,P.T. CRUISER,2000,2,0,0.0,2,100.0,0,0.0
CHRYSLER,P.T. CRUISER,2001,6,0,0.0,6,100.0,0,0.0
CHRYSLER,P.T. CRUISER,2002,13,2,15.4,11,84.6,0,0.0
CHRYSLER,P.T. CRUISER,2003,13,3,23.1,10,76.9,0,0.0
CHRYSLER,P.T. CRUISER,2004,21,7,33.3,14,66.7,0,0.0
CHRYSLER,P.T. CRUISER,2005,9,2,22.2,7,77.8,0,0.0
CHRYSLER,P.T. CRUISER,2006,18,8,44.4,10,55.6,0,0.0
CHRYSLER,P.T. CRUISER,2007,10,3,30.0,7,70.0,0,0.0
CHRYSLER,P.T. CRUISER,2008,1,0,0.0,1,100.0,0,0.0
CHRYSLER,SEBRING,2008,25,4,16.0,21,84.0,0,0.0
CHRYSLER,SEBRING,2009,10,2,20.0,8,80.0,0,0.0
CHRYSLER,SEBRING,2010,5,0,0.0,5,100.0,0,0.0
CHRYSLER,VOYAGER,1998,1,0,0.0,1,100.0,0,0.0
CHRYSLER,VOYAGER,1999,4,0,0.0,4,100.0,0,0.0
CHRYSLER,VOYAGER,2000,5,1,20.0,4,80.0,0,0.0
CHRYSLER,VOYAGER,2001,2,0,0.0,2,100.0,0,0.0
CHRYSLER,VOYAGER,2002,2,0,0.0,2,100.0,0,0.0
CHRYSLER,VOYAGER,2003,18,4,22.2,14,77.8,0,0.0
CHRYSLER,VOYAGER,2004,21,7,33.3,14,66.7,0,0.0
CHRYSLER,VOYAGER,2005,37,11,29.7,26,70.3,0,0.0
CHRYSLER,VOYAGER,2006,55,21,38.2,34,61.8,0,0.0
CHRYSLER,VOYAGER,2007,38,16,42.1,22,57.9,0,0.0
CHRYSLER,VOYAGER,2008,18,5,27.8,13,72.2,0,0.0
CHRYSLER,VOYAGER,2009,1,0,0.0,1,100.0,0,0.0
CHRYSLER,VOYAGER,2010,6,2,33.3,4,66.7,0,0.0
CHRYSLER,VOYAGER,2011,1,1,100.0,0,0.0,0,0.0
CHRYSLER,VOYAGER,2012,1,0,0.0,1,100.0,0,0.0
CHRYSLER,VOYAGER,2013,1,1,100.0,0,0.0,0,0.0
CHRYSLER,WRANGLER,1998,1,0,0.0,1,100.0,0,0.0
CHRYSLER,WRANGLER,2007,9,4,44.4,5,55.6,0,0.0
CHRYSLER,WRANGLER,2008,7,3,42.9,4,57.1,0,0.0
CHRYSLER,WRANGLER,2012,1,1,100.0,0,0.0,0,0.0
CHRYSLER,YPSILON,2011,2,2,100.0,0,0.0,0,0.0
CHRYSLER,YPSILON,2012,27,16,59.3,11,40.7,0,0.0
CHRYSLER,YPSILON,2014,4,2,50.0,2,50.0,0,0.0
CHRYSLER,YPSILON,2015,1,1,100.0,0,0.0,0,0.0
CHRYSLER JEEP,CHEROKEE,2004,1,1,100.0,0,0.0,0,0.0
CHRYSLER JEEP,CHEROKEE,2005,2,1,50.0,1,50.0,0,0.0
CHRYSLER JEEP,COMMANDER,2007,3,0,0.0,3,100.0,0,0.0
CHRYSLER JEEP,COMMANDER,2009,1,1,100.0,0,0.0,0,0.0
CHRYSLER JEEP,COMPASS,2006,1,1,100.0,0,0.0,0,0.0
CHRYSLER JEEP,COMPASS,2011,1,0,0.0,1,100.0,0,0.0
CHRYSLER JEEP,GRAND CHEROKEE,2006,1,0,0.0,1,100.0,0,0.0
CHRYSLER JEEP,GRAND CHEROKEE,2008,1,1,100.0,0,0.0,0,0.0
CHRYSLER JEEP,GRAND CHEROKEE,2011,1,1,100.0,0,0.0,0,0.0
CHRYSLER JEEP,GRAND CHEROKEE,2012,2,1,50.0,1,50.0,0,0.0
CHRYSLER JEEP,GRAND CHEROKEE,2013,1,1,100.0,0,0.0,0,0.0
CHRYSLER JEEP,GRAND CHEROKEE,2014,1,1,100.0,0,0.0,0,0.0
CHRYSLER JEEP,PATRIOT,2009,1,0,0.0,1,100.0,0,0.0
CHRYSLER JEEP,RENEGADE,2016,1,1,100.0,0,0.0,0,0.0
CHRYSLER JEEP,WRANGLER,2005,1,1,100.0,0,0.0,0,0.0
CHRYSLER JEEP,WRANGLER,2007,1,0,0.0,1,100.0,0,0.0
CHRYSLER JEEP,WRANGLER,2011,1,1,100.0,0,0.0,0,0.0
CHRYSLER JEEP,WRANGLER,2014,2,2,100.0,0,0.0,0,0.0
CITROEN,2CV/DYANNE,1980,1,1,100.0,0,0.0,0,0.0
CITROEN,2CV/DYANNE,1982,1,0,0.0,1,100.0,0,0.0
CITROEN,2CV/DYANNE,1984,2,0,0.0,2,100.0,0,0.0
CITROEN,2CV/DYANNE,1985,1,0,0.0,1,100.0,0,0.0
CITROEN,2CV/DYANNE,1986,2,0,0.0,2,100.0,0,0.0
CITROEN,2CV/DYANNE,1987,4,2,50.0,2,50.0,0,0.0
CITROEN,2CV/DYANNE,1988,5,1,20.0,4,80.0,0,0.0
CITROEN,2CV/DYANNE,1990,1,0,0.0,1,100.0,0,0.0
CITROEN,2CV6 SPECIAL,1984,2,0,0.0,2,100.0,0,0.0
CITROEN,2CV6 SPECIAL,1986,3,1,33.3,2,66.7,0,0.0
CITROEN,2CV6 SPECIAL,1987,3,0,0.0,3,100.0,0,0.0
CITROEN,2CV6 SPECIAL,1988,4,0,0.0,4,100.0,0,0.0
CITROEN,2CV6 SPECIAL,1989,3,3,100.0,0,0.0,0,0.0
CITROEN,2CV6 SPECIAL,1990,1,1,100.0,0,0.0,0,0.0
CITROEN,AX,1990,1,0,0.0,1,100.0,0,0.0
CITROEN,AX,1991,2,1,50.0,1,50.0,0,0.0
CITROEN,AX,1992,1,0,0.0,1,100.0,0,0.0
CITROEN,AX,1993,2,1,50.0,1,50.0,0,0.0
CITROEN,AX,1994,1,0,0.0,1,100.0,0,0.0
CITROEN,AX,1995,2,1,50.0,1,50.0,0,0.0
CITROEN,BERLINGO,1998,6,1,16.7,5,83.3,0,0.0
CITROEN,BERLINGO,1999,1,0,0.0,1,100.0,0,0.0
CITROEN,BERLINGO,2000,7,3,42.9,4,57.1,0,0.0
CITROEN,BERLINGO,2001,32,10,31.3,22,68.8,0,0.0
CITROEN,BERLINGO,2002,53,18,34.0,35,66.0,0,0.0
CITROEN,BERLINGO,2003,96,30,31.3,66,68.8,0,0.0
CITROEN,BERLINGO,2004,117,39,33.3,78,66.7,0,0.0
CITROEN,BERLINGO,2005,51,25,49.0,26,51.0,0,0.0
CITROEN,BERLINGO,2006,78,39,50.0,39,50.0,0,0.0
CITROEN,BERLINGO,2007,57,22,38.6,35,61.4,1,1.8
CITROEN,BERLINGO,2008,72,37,51.4,35,48.6,0,0.0
CITROEN,BERLINGO,2009,59,26,44.1,33,55.9,0,0.0
CITROEN,BERLINGO,2010,134,65,48.5,69,51.5,0,0.0
CITROEN,BERLINGO,2011,60,39,65.0,21,35.0,1,1.7
CITROEN,BERLINGO,2012,168,103,61.3,65,38.7,1,0.6
CITROEN,BERLINGO,2013,47,22,46.8,25,53.2,0,0.0
CITROEN,BERLINGO,2014,143,92,64.3,51,35.7,3,2.1
CITROEN,BERLINGO,2015,17,11,64.7,6,35.3,2,11.8
CITROEN,BERLINGO,2016,1,0,0.0,1,100.0,0,0.0
CITROEN,BERLINGO,2017,1,0,0.0,1,100.0,0,0.0
CITROEN,BERLINGO,2018,1,1,100.0,0,0.0,0,0.0
CITROEN,BX,1984,2,1,50.0,1,50.0,0,0.0
CITROEN,BX,1987,2,1,50.0,1,50.0,0,0.0
CITROEN,BX,1990,1,0,0.0,1,100.0,0,0.0
CITROEN,C1,2005,22,13,59.1,9,40.9,0,0.0
CITROEN,C1,2006,221,119,53.8,102,46.2,0,0.0
CITROEN,C1,2007,93,42,45.2,51,54.8,0,0.0
CITROEN,C1,2008,50,19,38.0,31,62.0,0,0.0
CITROEN,C1,2009,32,19,59.4,13,40.6,0,0.0
CITROEN,C1,2010,58,38,65.5,20,34.5,0,0.0
CITROEN,C1,2011,16,7,43.8,9,56.3,0,0.0
CITROEN,C1,2012,42,30,71.4,12,28.6,0,0.0
CITROEN,C1,2013,13,10,76.9,3,23.1,0,0.0
CITROEN,C1,2014,43,31,72.1,12,27.9,0,0.0
CITROEN,C1,2015,10,8,80.0,2,20.0,0,0.0
CITROEN,C2,2003,9,4,44.4,5,55.6,0,0.0
CITROEN,C2,2004,225,71,31.6,154,68.4,0,0.0
CITROEN,C2,2005,124,49,39.5,75,60.5,0,0.0
CITROEN,C2,2006,92,45,48.9,47,51.1,0,0.0
CITROEN,C2,2007,44,19,43.2,25,56.8,0,0.0
CITROEN,C2,2008,23,6,26.1,17,73.9,0,0.0
CITROEN,C2,2009,23,8,34.8,15,65.2,0,0.0
CITROEN,C2,2010,2,1,50.0,1,50.0,0,0.0
CITROEN,C3,2002,106,37,34.9,69,65.1,0,0.0
CITROEN,C3,2003,650,194,29.8,456,70.2,0,0.0
CITROEN,C3,2004,619,225,36.3,394,63.7,0,0.0
CITROEN,C3,2005,630,248,39.4,382,60.6,0,0.0
CITROEN,C3,2006,580,264,45.5,316,54.5,0,0.0
CITROEN,C3,2007,369,169,45.8,200,54.2,0,0.0
CITROEN,C3,2008,224,102,45.5,122,54.5,0,0.0
CITROEN,C3,2009,76,28,36.8,48,63.2,0,0.0
CITROEN,C3,2010,357,182,51.0,175,49.0,0,0.0
CITROEN,C3,2011,61,33,54.1,28,45.9,0,0.0
CITROEN,C3,2012,179,113,63.1,66,36.9,0,0.0
CITROEN,C3,2013,42,32,76.2,10,23.8,0,0.0
CITROEN,C3,2014,162,132,81.5,30,18.5,0,0.0
CITROEN,C3,2015,16,16,100.0,0,0.0,0,0.0
CITROEN,C3 PICASSO,2009,22,6,27.3,16,72.7,0,0.0
CITROEN,C3 PICASSO,2010,67,37,55.2,30,44.8,0,0.0
CITROEN,C3 PICASSO,2011,25,14,56.0,11,44.0,0,0.0
CITROEN,C3 PICASSO,2012,40,26,65.0,14,35.0,0,0.0
CITROEN,C3 PICASSO,2013,6,4,66.7,2,33.3,0,0.0
CITROEN,C3 PICASSO,2014,20,16,80.0,4,20.0,0,0.0
CITROEN,C3 PICASSO,2015,1,0,0.0,1,100.0,0,0.0
CITROEN,C4,2004,12,0,0.0,12,100.0,0,0.0
CITROEN,C4,2005,978,281,28.7,697,71.3,0,0.0
CITROEN,C4,2006,707,241,34.1,466,65.9,1,0.1
CITROEN,C4,2007,1104,397,36.0,707,64.0,0,0.0
CITROEN,C4,2008,1566,559,35.7,1007,64.3,0,0.0
CITROEN,C4,2009,651,264,40.6,387,59.4,1,0.2
CITROEN,C4,2010,1776,788,44.4,988,55.6,1,0.1
CITROEN,C4,2011,320,181,56.6,139,43.4,0,0.0
CITROEN,C4,2012,957,654,68.3,303,31.7,1,0.1
CITROEN,C4,2013,198,123,62.1,75,37.9,1,0.5
CITROEN,C4,2014,1350,995,73.7,355,26.3,0,0.0
CITROEN,C4,2015,109,82,75.2,27,24.8,0,0.0
CITROEN,C4,2016,9,8,88.9,1,11.1,0,0.0
CITROEN,C4 CACTUS,2014,12,6,50.0,6,50.0,0,0.0
CITROEN,C4 CACTUS,2015,2,0,0.0,2,100.0,0,0.0
CITROEN,C4 PICASSO,2007,90,32,35.6,58,64.4,0,0.0
CITROEN,C4 PICASSO,2008,90,32,35.6,58,64.4,0,0.0
CITROEN,C4 PICASSO,2009,11,4,36.4,7,63.6,0,0.0
CITROEN,C4 PICASSO,2010,2,1,50.0,1,50.0,0,0.0
CITROEN,C4 PICASSO,2011,3,2,66.7,1,33.3,0,0.0
CITROEN,C4 PICASSO,2012,5,3,60.0,2,40.0,0,0.0
CITROEN,C4 PICASSO,2013,2,0,0.0,2,100.0,0,0.0
CITROEN,C5,2001,27,6,22.2,21,77.8,0,0.0
CITROEN,C5,2002,104,38,36.5,66,63.5,0,0.0
CITROEN,C5,2003,153,53,34.6,100,65.4,0,0.0
CITROEN,C5,2004,177,62,35.0,115,65.0,0,0.0
CITROEN,C5,2005,294,90,30.6,204,69.4,0,0.0
CITROEN,C5,2006,370,104,28.1,266,71.9,0,0.0
CITROEN,C5,2007,230,61,26.5,169,73.5,0,0.0
CITROEN,C5,2008,757,237,31.3,520,68.7,0,0.0
CITROEN,C5,2009,423,150,35.5,273,64.5,0,0.0
CITROEN,C5,2010,498,204,41.0,294,59.0,0,0.0
CITROEN,C5,2011,64,31,48.4,33,51.6,0,0.0
CITROEN,C5,2012,173,96,55.5,77,44.5,1,0.6
CITROEN,C5,2013,28,16,57.1,12,42.9,0,0.0
CITROEN,C5,2014,100,70,70.0,30,30.0,0,0.0
CITROEN,C5,2015,16,15,93.8,1,6.3,0,0.0
CITROEN,C5,2016,1,1,100.0,0,0.0,0,0.0
CITROEN,C6,2006,8,2,25.0,6,75.0,0,0.0
CITROEN,C6,2007,24,7,29.2,17,70.8,0,0.0
CITROEN,C6,2008,4,0,0.0,4,100.0,0,0.0
CITROEN,C8,2003,10,1,10.0,9,90.0,0,0.0
CITROEN,C8,2004,5,3,60.0,2,40.0,0,0.0
CITROEN,C8,2005,12,1,8.3,11,91.7,0,0.0
CITROEN,C8,2006,42,6,14.3,36,85.7,0,0.0
CITROEN,C8,2007,45,8,17.8,37,82.2,0,0.0
CITROEN,C8,2008,22,4,18.2,18,81.8,0,0.0
CITROEN,C8,2009,5,0,0.0,5,100.0,0,0.0
CITROEN,C8,2010,1,0,0.0,1,100.0,0,0.0
CITROEN,C-CROSSER,2007,6,3,50.0,3,50.0,0,0.0
CITROEN,C-CROSSER,2008,34,12,35.3,22,64.7,0,0.0
CITROEN,C-CROSSER,2009,2,1,50.0,1,50.0,0,0.0
CITROEN,C-CROSSER,2010,1,0,0.0,1,100.0,0,0.0
CITROEN,C-CROSSER,2012,1,0,0.0,1,100.0,0,0.0
CITROEN,CX,1985,1,0,0.0,1,100.0,0,0.0
CITROEN,CX,1988,1,0,0.0,1,100.0,0,0.0
CITROEN,CX,1989,1,0,0.0,1,100.0,0,0.0
CITROEN,C-ZERO,2012,3,3,100.0,0,0.0,0,0.0
CITROEN,C-ZERO,2013,2,1,50.0,1,50.0,0,0.0
CITROEN,DISPATCH,2002,2,1,50.0,1,50.0,0,0.0
CITROEN,DISPATCH,2003,1,0,0.0,1,100.0,0,0.0
CITROEN,DISPATCH,2004,1,1,100.0,0,0.0,0,0.0
CITROEN,DISPATCH,2005,4,1,25.0,3,75.0,0,0.0
CITROEN,DISPATCH,2006,9,3,33.3,6,66.7,1,11.1
CITROEN,DISPATCH,2007,3,2,66.7,1,33.3,0,0.0
CITROEN,DISPATCH,2008,9,4,44.4,5,55.6,1,11.1
CITROEN,DISPATCH,2009,9,1,11.1,8,88.9,0,0.0
CITROEN,DISPATCH,2010,24,11,45.8,13,54.2,0,0.0
CITROEN,DISPATCH,2011,7,3,42.9,4,57.1,1,14.3
CITROEN,DISPATCH,2012,11,6,54.5,5,45.5,0,0.0
CITROEN,DISPATCH,2013,3,1,33.3,2,66.7,0,0.0
CITROEN,DISPATCH,2014,10,8,80.0,2,20.0,0,0.0
CITROEN,DISPATCH,2015,2,0,0.0,2,100.0,0,0.0
CITROEN,DISPATCH,2017,1,1,100.0,0,0.0,0,0.0
CITROEN,DS3,2010,44,19,43.2,25,56.8,0,0.0
CITROEN,DS3,2011,21,10,47.6,11,52.4,0,0.0
CITROEN,DS3,2012,65,38,58.5,27,41.5,0,0.0
CITROEN,DS3,2013,23,17,73.9,6,26.1,0,0.0
CITROEN,DS3,2014,87,66,75.9,21,24.1,0,0.0
CITROEN,DS3,2015,5,3,60.0,2,40.0,0,0.0
CITROEN,DS3,2016,2,0,0.0,2,100.0,0,0.0
CITROEN,DS4,2011,12,5,41.7,7,58.3,0,0.0
CITROEN,DS4,2012,109,82,75.2,27,24.8,0,0.0
CITROEN,DS4,2013,25,17,68.0,8,32.0,0,0.0
CITROEN,DS4,2014,57,52,91.2,5,8.8,0,0.0
CITROEN,DS4,2015,4,3,75.0,1,25.0,0,0.0
CITROEN,DS4,2016,1,1,100.0,0,0.0,0,0.0
CITROEN,DS5,2012,72,41,56.9,31,43.1,0,0.0
CITROEN,DS5,2013,25,15,60.0,10,40.0,0,0.0
CITROEN,DS5,2014,37,18,48.6,19,51.4,1,2.7
CITROEN,DS5,2015,2,1,50.0,1,50.0,0,0.0
CITROEN,GRAND C4PICASSO,2010,1,1,100.0,0,0.0,0,0.0
CITROEN,GRAND C4PICASSO,2014,1,1,100.0,0,0.0,0,0.0
CITROEN,GRAND C4PICASSO,2016,1,1,100.0,0,0.0,0,0.0
CITROEN,GS/GSA,1983,1,1,100.0,0,0.0,0,0.0
CITROEN,GS/GSA,1988,1,1,100.0,0,0.0,0,0.0
CITROEN,NEMO,2009,6,2,33.3,4,66.7,0,0.0
CITROEN,NEMO,2010,10,3,30.0,7,70.0,0,0.0
CITROEN,NEMO,2011,2,2,100.0,0,0.0,0,0.0
CITROEN,NEW C5,2010,1,1,100.0,0,0.0,0,0.0
CITROEN,NEW C5,2011,2,0,0.0,2,100.0,0,0.0
CITROEN,OTHER,1983,1,0,0.0,1,100.0,0,0.0
CITROEN,OTHER,1986,1,0,0.0,1,100.0,0,0.0
CITROEN,OTHER,1989,1,1,100.0,0,0.0,0,0.0
CITROEN,OTHER,1990,1,0,0.0,1,100.0,0,0.0
CITROEN,OTHER,1999,1,1,100.0,0,0.0,0,0.0
CITROEN,OTHER,2000,1,0,0.0,1,100.0,0,0.0
CITROEN,OTHER,2001,9,1,11.1,8,88.9,0,0.0
CITROEN,OTHER,2002,128,48,37.5,80,62.5,0,0.0
CITROEN,OTHER,2003,95,31,32.6,64,67.4,0,0.0
CITROEN,OTHER,2004,49,17,34.7,32,65.3,0,0.0
CITROEN,OTHER,2005,64,20,31.3,44,68.8,0,0.0
CITROEN,OTHER,2006,42,18,42.9,24,57.1,0,0.0
CITROEN,OTHER,2007,26,10,38.5,16,61.5,0,0.0
CITROEN,OTHER,2008,21,9,42.9,12,57.1,0,0.0
CITROEN,OTHER,2010,1,0,0.0,1,100.0,0,0.0
CITROEN,OTHER,2011,1,0,0.0,1,100.0,0,0.0
CITROEN,OTHER,2012,2,1,50.0,1,50.0,0,0.0
CITROEN,OTHER,2013,6,4,66.7,2,33.3,0,0.0
CITROEN,OTHER,2014,6,3,50.0,3,50.0,0,0.0
CITROEN,OTHER,2015,1,1,100.0,0,0.0,0,0.0
CITROEN,PICASSO,2002,60,19,31.7,41,68.3,0,0.0
CITROEN,PICASSO,2003,51,15,29.4,36,70.6,0,0.0
CITROEN,PICASSO,2004,163,52,31.9,111,68.1,0,0.0
CITROEN,PICASSO,2005,30,12,40.0,18,60.0,0,0.0
CITROEN,PICASSO,2006,7,1,14.3,6,85.7,0,0.0
CITROEN,PICASSO,2007,10,3,30.0,7,70.0,0,0.0
CITROEN,PICASSO,2008,8,6,75.0,2,25.0,0,0.0
CITROEN,RELAY,2004,1,0,0.0,1,100.0,0,0.0
CITROEN,RELAY,2005,1,0,0.0,1,100.0,0,0.0
CITROEN,RELAY,2012,1,0,0.0,1,100.0,0,0.0
CITROEN,RELAY,2014,1,1,100.0,0,0.0,0,0.0
CITROEN,SAXO,1996,2,2,100.0,0,0.0,0,0.0
CITROEN,SAXO,1997,13,4,30.8,9,69.2,0,0.0
CITROEN,SAXO,1998,16,5,31.3,11,68.8,0,0.0
CITROEN,SAXO,1999,24,5,20.8,19,79.2,0,0.0
CITROEN,SAXO,2000,55,14,25.5,41,74.5,0,0.0
CITROEN,SAXO,2001,57,20,35.1,37,64.9,0,0.0
CITROEN,SAXO,2002,53,18,34.0,35,66.0,0,0.0
CITROEN,SAXO,2003,22,9,40.9,13,59.1,0,0.0
CITROEN,SAXO,2004,7,0,0.0,7,100.0,0,0.0
CITROEN,SAXO,2005,1,0,0.0,1,100.0,0,0.0
CITROEN,SYNERGIE,2000,2,1,50.0,1,50.0,0,0.0
CITROEN,SYNERGIE,2001,1,0,0.0,1,100.0,0,0.0
CITROEN,SYNERGIE,2002,4,2,50.0,2,50.0,0,0.0
CITROEN,VISA,1982,1,1,100.0,0,0.0,0,0.0
CITROEN,X250,2014,1,1,100.0,0,0.0,0,0.0
CITROEN,XANTIA,1994,2,0,0.0,2,100.0,0,0.0
CITROEN,XANTIA,1995,2,0,0.0,2,100.0,0,0.0
CITROEN,XANTIA,1996,4,1,25.0,3,75.0,0,0.0
CITROEN,XANTIA,1997,4,2,50.0,2,50.0,0,0.0
CITROEN,XANTIA,1998,17,9,52.9,8,47.1,0,0.0
CITROEN,XANTIA,1999,15,8,53.3,7,46.7,0,0.0
CITROEN,XANTIA,2000,20,8,40.0,12,60.0,0,0.0
CITROEN,XANTIA,2001,7,2,28.6,5,71.4,0,0.0
CITROEN,XM,1991,1,0,0.0,1,100.0,0,0.0
CITROEN,XM,1995,1,0,0.0,1,100.0,0,0.0
CITROEN,XM,1996,4,1,25.0,3,75.0,0,0.0
CITROEN,XM,1997,1,1,100.0,0,0.0,0,0.0
CITROEN,XM,1998,1,0,0.0,1,100.0,0,0.0
CITROEN,XM,1999,1,0,0.0,1,100.0,0,0.0
CITROEN,XSARA,1997,3,2,66.7,1,33.3,0,0.0
CITROEN,XSARA,1998,13,4,30.8,9,69.2,0,0.0
CITROEN,XSARA,1999,20,6,30.0,14,70.0,0,0.0
CITROEN,XSARA,2000,54,16,29.6,38,70.4,0,0.0
CITROEN,XSARA,2001,86,32,37.2,54,62.8,0,0.0
CITROEN,XSARA,2002,128,36,28.1,92,71.9,0,0.0
CITROEN,XSARA,2003,192,56,29.2,136,70.8,0,0.0
CITROEN,XSARA,2004,247,82,33.2,165,66.8,0,0.0
CITROEN,XSARA,2005,286,85,29.7,201,70.3,0,0.0
CITROEN,XSARA,2006,107,32,29.9,75,70.1,0,0.0
CITROEN,XSARA,2007,107,36,33.6,71,66.4,0,0.0
CITROEN,XSARA,2008,187,81,43.3,106,56.7,0,0.0
CITROEN,XSARA,2009,40,10,25.0,30,75.0,0,0.0
CITROEN,XSARA,2010,16,4,25.0,12,75.0,0,0.0
CITROEN,XSARA PICASSO,2001,1,1,100.0,0,0.0,0,0.0
CITROEN,XSARA PICASSO,2004,3,1,33.3,2,66.7,0,0.0
CITROEN,XSARA PICASSO,2005,6,2,33.3,4,66.7,0,0.0
CITROEN,XSARA PICASSO,2006,237,91,38.4,146,61.6,0,0.0
CITROEN,XSARA PICASSO,2007,73,27,37.0,46,63.0,0,0.0
CITROEN,XSARA PICASSO,2008,5,1,20.0,4,80.0,0,0.0
CITROEN,XSARA PICASSO,2009,1,0,0.0,1,100.0,0,0.0
CITROEN,XSARA PICASSO,2010,33,14,42.4,19,57.6,0,0.0
CITROEN,XSARA PICASSO,2011,4,1,25.0,3,75.0,0,0.0
CITROEN,ZX,1992,1,1,100.0,0,0.0,0,0.0
CITROEN,ZX,1993,3,0,0.0,3,100.0,0,0.0
CITROEN,ZX,1994,4,1,25.0,3,75.0,0,0.0
CITROEN,ZX,1995,6,4,66.7,2,33.3,0,0.0
CITROEN,ZX,1996,5,2,40.0,3,60.0,0,0.0
CITROEN,ZX,1997,2,1,50.0,1,50.0,0,0.0
CITROEN,ZX,1998,1,0,0.0,1,100.0,0,0.0
CITROEN,ZX,2008,2,1,50.0,1,50.0,0,0.0
DACIA,DUSTER,2013,32,19,59.4,13,40.6,0,0.0
DACIA,DUSTER,2014,825,612,74.2,213,25.8,4,0.5
DACIA,DUSTER,2015,137,105,76.6,32,23.4,0,0.0
DACIA,DUSTER,2016,22,14,63.6,8,36.4,0,0.0
DACIA,DUSTER,2017,13,11,84.6,2,15.4,0,0.0
DACIA,DUSTER,2018,1,1,100.0,0,0.0,0,0.0
DACIA,LOGAN,2013,4,1,25.0,3,75.0,0,0.0
DACIA,LOGAN,2014,212,157,74.1,55,25.9,1,0.5
DACIA,LOGAN,2015,35,27,77.1,8,22.9,0,0.0
DACIA,LOGAN,2016,32,24,75.0,8,25.0,0,0.0
DACIA,LOGAN,2017,30,26,86.7,4,13.3,0,0.0
DACIA,LOGAN,2018,6,5,83.3,1,16.7,0,0.0
DACIA,OTHER,2007,3,1,33.3,2,66.7,0,0.0
DACIA,OTHER,2008,1,0,0.0,1,100.0,0,0.0
DACIA,OTHER,2013,89,63,70.8,26,29.2,0,0.0
DACIA,OTHER,2014,594,446,75.1,148,24.9,1,0.2
DACIA,OTHER,2015,3,1,33.3,2,66.7,0,0.0
DACIA,SANDERO,2009,1,0,0.0,1,100.0,0,0.0
DACIA,SANDERO,2012,2,1,50.0,1,50.0,0,0.0
DACIA,SANDERO,2013,65,49,75.4,16,24.6,0,0.0
DACIA,SANDERO,2014,833,648,77.8,185,22.2,1,0.1
DACIA,SANDERO,2015,107,85,79.4,22,20.6,0,0.0
DACIA,SANDERO,2017,2,2,100.0,0,0.0,0,0.0
DAEWOO,KALOS,2002,6,0,0.0,6,100.0,0,0.0
DAEWOO,KALOS,2003,312,79,25.3,233,74.7,0,0.0
DAEWOO,KALOS,2004,319,101,31.7,218,68.3,0,0.0
DAEWOO,KALOS,2005,1,0,0.0,1,100.0,0,0.0
DAEWOO,LACETTI,2004,60,19,31.7,41,68.3,0,0.0
DAEWOO,LACETTI,2005,2,0,0.0,2,100.0,0,0.0
DAEWOO,LANOS,1998,1,0,0.0,1,100.0,0,0.0
DAEWOO,LANOS,1999,42,19,45.2,23,54.8,0,0.0
DAEWOO,LANOS,2000,121,34,28.1,87,71.9,0,0.0
DAEWOO,LANOS,2001,59,18,30.5,41,69.5,0,0.0
DAEWOO,LANOS,2002,44,14,31.8,30,68.2,0,0.0
DAEWOO,LANOS,2003,3,1,33.3,2,66.7,0,0.0
DAEWOO,LEGANZA,2000,1,1,100.0,0,0.0,0,0.0
DAEWOO,LEGANZA,2002,1,1,100.0,0,0.0,0,0.0
DAEWOO,MATIZ,1999,7,3,42.9,4,57.1,0,0.0
DAEWOO,MATIZ,2000,37,10,27.0,27,73.0,0,0.0
DAEWOO,MATIZ,2001,27,10,37.0,17,63.0,0,0.0
DAEWOO,MATIZ,2002,40,7,17.5,33,82.5,0,0.0
DAEWOO,MATIZ,2003,26,8,30.8,18,69.2,0,0.0
DAEWOO,MATIZ,2004,27,8,29.6,19,70.4,0,0.0
DAEWOO,MATIZ,2005,1,0,0.0,1,100.0,0,0.0
DAEWOO,MATIZ,2007,1,0,0.0,1,100.0,0,0.0
DAEWOO,MUSSO,2001,2,0,0.0,2,100.0,0,0.0
DAEWOO,NUBIRA,1999,1,1,100.0,0,0.0,0,0.0
DAEWOO,NUBIRA,2001,1,1,100.0,0,0.0,0,0.0
DAEWOO,NUBIRA,2003,4,1,25.0,3,75.0,0,0.0
DAEWOO,NUBIRA,2004,85,23,27.1,62,72.9,0,0.0
DAEWOO,OTHER,1997,1,1,100.0,0,0.0,0,0.0
DAEWOO,OTHER,2001,2,2,100.0,0,0.0,0,0.0
DAEWOO,OTHER,2003,4,0,0.0,4,100.0,0,0.0
DAEWOO,OTHER,2004,1,0,0.0,1,100.0,0,0.0
DAEWOO,REXTON,2004,7,2,28.6,5,71.4,0,0.0
DAEWOO,TACUMA,2003,4,2,50.0,2,50.0,0,0.0
DAEWOO,TACUMA,2004,7,2,28.6,5,71.4,0,0.0
DAIHATSU,BOON,2006,1,0,0.0,1,100.0,0,0.0
DAIHATSU,CHARADE,1985,1,1,100.0,0,0.0,0,0.0
DAIHATSU,CHARADE,1986,2,1,50.0,1,50.0,0,0.0
DAIHATSU,CHARADE,1989,1,1,100.0,0,0.0,0,0.0
DAIHATSU,CHARADE,1990,3,0,0.0,3,100.0,0,0.0
DAIHATSU,CHARADE,1991,7,1,14.3,6,85.7,0,0.0
DAIHATSU,CHARADE,1992,2,1,50.0,1,50.0,0,0.0
DAIHATSU,CHARADE,1993,9,3,33.3,6,66.7,0,0.0
DAIHATSU,CHARADE,1995,3,1,33.3,2,66.7,0,0.0
DAIHATSU,CHARADE,1997,3,1,33.3,2,66.7,0,0.0
DAIHATSU,CHARADE,2003,30,8,26.7,22,73.3,0,0.0
DAIHATSU,CHARADE,2004,59,29,49.2,30,50.8,0,0.0
DAIHATSU,CHARADE,2005,52,29,55.8,23,44.2,0,0.0
DAIHATSU,CHARADE,2006,27,18,66.7,9,33.3,0,0.0
DAIHATSU,CHARADE,2007,24,15,62.5,9,37.5,0,0.0
DAIHATSU,CHARADE,2008,1,1,100.0,0,0.0,0,0.0
DAIHATSU,CHARMANT,1985,1,1,100.0,0,0.0,0,0.0
DAIHATSU,CHARMANT,1987,1,0,0.0,1,100.0,0,0.0
DAIHATSU,CHARMANT,1988,1,1,100.0,0,0.0,0,0.0
DAIHATSU,COPEN,2003,1,0,0.0,1,100.0,0,0.0
DAIHATSU,COPEN,2004,9,2,22.2,7,77.8,0,0.0
DAIHATSU,COPEN,2005,2,1,50.0,1,50.0,0,0.0
DAIHATSU,COPEN,2006,2,1,50.0,1,50.0,0,0.0
DAIHATSU,COPEN,2007,6,3,50.0,3,50.0,0,0.0
DAIHATSU,COPEN,2008,6,3,50.0,3,50.0,0,0.0
DAIHATSU,COPEN,2009,2,2,100.0,0,0.0,0,0.0
DAIHATSU,COPEN,2010,1,0,0.0,1,100.0,0,0.0
DAIHATSU,CUORE,1999,21,5,23.8,16,76.2,0,0.0
DAIHATSU,CUORE,2000,48,17,35.4,31,64.6,0,0.0
DAIHATSU,CUORE,2001,13,5,38.5,8,61.5,0,0.0
DAIHATSU,CUORE,2002,5,0,0.0,5,100.0,0,0.0
DAIHATSU,CUORE,2003,2,1,50.0,1,50.0,0,0.0
DAIHATSU,DOMINO,1987,1,1,100.0,0,0.0,0,0.0
DAIHATSU,DOMINO,1988,1,1,100.0,0,0.0,0,0.0
DAIHATSU,FOURTRACK,1990,1,1,100.0,0,0.0,0,0.0
DAIHATSU,MIRA,2002,1,1,100.0,0,0.0,0,0.0
DAIHATSU,OTHER,1991,2,2,100.0,0,0.0,0,0.0
DAIHATSU,OTHER,1992,1,0,0.0,1,100.0,0,0.0
DAIHATSU,OTHER,1993,2,0,0.0,2,100.0,0,0.0
DAIHATSU,OTHER,1994,3,1,33.3,2,66.7,0,0.0
DAIHATSU,OTHER,1995,2,0,0.0,2,100.0,0,0.0
DAIHATSU,OTHER,1999,3,0,0.0,3,100.0,0,0.0
DAIHATSU,OTHER,2000,1,0,0.0,1,100.0,0,0.0
DAIHATSU,OTHER,2001,8,3,37.5,5,62.5,0,0.0
DAIHATSU,OTHER,2002,15,6,40.0,9,60.0,0,0.0
DAIHATSU,OTHER,2003,6,1,16.7,5,83.3,0,0.0
DAIHATSU,OTHER,2004,1,0,0.0,1,100.0,0,0.0
DAIHATSU,OTHER,2005,2,2,100.0,0,0.0,0,0.0
DAIHATSU,OTHER,2006,1,1,100.0,0,0.0,0,0.0
DAIHATSU,OTHER,2007,2,2,100.0,0,0.0,0,0.0
DAIHATSU,OTHER,2008,5,4,80.0,1,20.0,0,0.0
DAIHATSU,OTHER,2009,5,3,60.0,2,40.0,0,0.0
DAIHATSU,SIRION,1999,12,2,16.7,10,83.3,0,0.0
DAIHATSU,SIRION,2000,30,13,43.3,17,56.7,0,0.0
DAIHATSU,SIRION,2001,12,5,41.7,7,58.3,0,0.0
DAIHATSU,SIRION,2002,1,0,0.0,1,100.0,0,0.0
DAIHATSU,SIRION,2003,21,13,61.9,8,38.1,0,0.0
DAIHATSU,SIRION,2004,17,6,35.3,11,64.7,0,0.0
DAIHATSU,SIRION,2005,116,54,46.6,62,53.4,0,0.0
DAIHATSU,SIRION,2006,105,56,53.3,49,46.7,0,0.0
DAIHATSU,SIRION,2007,131,73,55.7,58,44.3,0,0.0
DAIHATSU,SIRION,2008,61,35,57.4,26,42.6,0,0.0
DAIHATSU,SIRION,2009,19,12,63.2,7,36.8,0,0.0
DAIHATSU,SIRION,2010,11,7,63.6,4,36.4,0,0.0
DAIHATSU,SIRION,2011,1,1,100.0,0,0.0,0,0.0
DAIHATSU,SIRION,2012,1,1,100.0,0,0.0,0,0.0
DAIHATSU,SIRION,2013,1,1,100.0,0,0.0,0,0.0
DAIHATSU,TERIOS,1997,4,1,25.0,3,75.0,0,0.0
DAIHATSU,TERIOS,1998,8,2,25.0,6,75.0,0,0.0
DAIHATSU,TERIOS,1999,21,6,28.6,15,71.4,0,0.0
DAIHATSU,TERIOS,2000,50,18,36.0,32,64.0,0,0.0
DAIHATSU,TERIOS,2001,51,16,31.4,35,68.6,0,0.0
DAIHATSU,TERIOS,2002,48,8,16.7,40,83.3,0,0.0
DAIHATSU,TERIOS,2003,66,24,36.4,42,63.6,0,0.0
DAIHATSU,TERIOS,2004,65,20,30.8,45,69.2,0,0.0
DAIHATSU,TERIOS,2005,67,28,41.8,39,58.2,0,0.0
DAIHATSU,TERIOS,2006,240,126,52.5,114,47.5,0,0.0
DAIHATSU,TERIOS,2007,433,253,58.4,180,41.6,1,0.2
DAIHATSU,TERIOS,2008,132,89,67.4,43,32.6,0,0.0
DAIHATSU,TERIOS,2009,15,7,46.7,8,53.3,0,0.0
DAIHATSU,TERIOS,2010,7,7,100.0,0,0.0,0,0.0
DAIHATSU,TERIOS,2011,1,0,0.0,1,100.0,0,0.0
DAIHATSU,YRV,2001,1,1,100.0,0,0.0,0,0.0
DAIHATSU,YRV,2002,4,1,25.0,3,75.0,0,0.0
DAIHATSU,YRV,2004,2,0,0.0,2,100.0,0,0.0
DAIMLER,OTHER,1968,1,1,100.0,0,0.0,0,0.0
DAIMLER,OTHER,1976,1,0,0.0,1,100.0,0,0.0
DAIMLER,OTHER,1980,1,0,0.0,1,100.0,0,0.0
DAIMLER,OTHER,1982,1,1,100.0,0,0.0,0,0.0
DAIMLER,OTHER,1983,3,1,33.3,2,66.7,0,0.0
DAIMLER,OTHER,1986,4,2,50.0,2,50.0,0,0.0
DAIMLER,OTHER,1987,1,1,100.0,0,0.0,0,0.0
DAIMLER,OTHER,1988,2,0,0.0,2,100.0,0,0.0
DAIMLER,OTHER,1989,2,1,50.0,1,50.0,0,0.0
DAIMLER,OTHER,1990,3,1,33.3,2,66.7,0,0.0
DAIMLER,OTHER,1992,1,1,100.0,0,0.0,0,0.0
DAIMLER,OTHER,1993,1,1,100.0,0,0.0,0,0.0
DAIMLER,OTHER,1996,2,1,50.0,1,50.0,0,0.0
DAIMLER,OTHER,1997,1,0,0.0,1,100.0,0,0.0
DAIMLER,OTHER,1998,3,1,33.3,2,66.7,0,0.0
DAIMLER,OTHER,1999,3,2,66.7,1,33.3,0,0.0
DAIMLER,OTHER,2001,1,0,0.0,1,100.0,0,0.0
DAIMLER,OTHER,2002,3,1,33.3,2,66.7,0,0.0
DAIMLER,OTHER,2006,3,3,100.0,0,0.0,0,0.0
DAIMLER,OTHER,2007,3,2,66.7,1,33.3,0,0.0
DAIMLER,OTHER,2008,2,1,50.0,1,50.0,0,0.0
DATSUN,OTHER,1981,1,1,100.0,0,0.0,0,0.0
DATSUN,OTHER,1982,2,1,50.0,1,50.0,0,0.0
DE LOREAN,OTHER,1981,2,1,50.0,1,50.0,0,0.0
DE LOREAN,OTHER,1982,2,0,0.0,2,100.0,0,0.0
DODGE,AVENGER,2007,2,1,50.0,1,50.0,0,0.0
DODGE,AVENGER,2008,5,1,20.0,4,80.0,0,0.0
DODGE,AVENGER,2009,1,0,0.0,1,100.0,0,0.0
DODGE,CALIBER,2006,22,9,40.9,13,59.1,0,0.0
DODGE,CALIBER,2007,73,17,23.3,56,76.7,0,0.0
DODGE,CALIBER,2008,17,3,17.6,14,82.4,0,0.0
DODGE,CALIBER,2009,8,0,0.0,8,100.0,0,0.0
DODGE,CALIBER,2010,1,0,0.0,1,100.0,0,0.0
DODGE,JOURNEY,2008,1,0,0.0,1,100.0,0,0.0
DODGE,JOURNEY,2009,15,2,13.3,13,86.7,0,0.0
DODGE,JOURNEY,2010,19,4,21.1,15,78.9,0,0.0
DODGE,NITRO,2007,1,0,0.0,1,100.0,0,0.0
DODGE,NITRO,2008,1,1,100.0,0,0.0,0,0.0
DODGE,NITRO,2009,1,0,0.0,1,100.0,0,0.0
DODGE,OTHER,1996,1,0,0.0,1,100.0,0,0.0
DODGE,OTHER,2004,3,1,33.3,2,66.7,1,33.3
DODGE,OTHER,2005,1,1,100.0,0,0.0,0,0.0
DODGE,OTHER,2006,1,0,0.0,1,100.0,0,0.0
DODGE,OTHER,2007,8,2,25.0,6,75.0,0,0.0
DODGE,OTHER,2008,3,0,0.0,3,100.0,0,0.0
DODGE,OTHER,2009,1,0,0.0,1,100.0,0,0.0
DODGE,OTHER,2012,3,1,33.3,2,66.7,0,0.0
DUFFY,E250,2004,1,1,100.0,0,0.0,0,0.0
DUFFY,OTHER,2012,1,0,0.0,1,100.0,0,0.0
DUFFY,OTHER,2014,6,3,50.0,3,50.0,0,0.0
FAIRWAY,DRIVER,1990,2,0,0.0,2,100.0,0,0.0
FAIRWAY,DRIVER,1995,1,0,0.0,1,100.0,0,0.0
FAIRWAY,OTHER,1996,2,2,100.0,0,0.0,0,0.0
FERRARI,360,2003,1,1,100.0,0,0.0,0,0.0
FERRARI,360,2004,1,1,100.0,0,0.0,0,0.0
FERRARI,360,2005,1,0,0.0,1,100.0,0,0.0
FERRARI,360,2009,1,1,100.0,0,0.0,0,0.0
FERRARI,360,2010,1,1,100.0,0,0.0,0,0.0
FERRARI,612,2008,1,1,100.0,0,0.0,0,0.0
FERRARI,612,2011,1,0,0.0,1,100.0,0,0.0
FERRARI,F430,2008,1,0,0.0,1,100.0,0,0.0
FERRARI,OTHER,1979,1,0,0.0,1,100.0,0,0.0
FERRARI,OTHER,1982,1,0,0.0,1,100.0,0,0.0
FERRARI,OTHER,1988,1,1,100.0,0,0.0,0,0.0
FERRARI,OTHER,1991,1,1,100.0,0,0.0,0,0.0
FERRARI,OTHER,1992,1,0,0.0,1,100.0,0,0.0
FERRARI,OTHER,1996,3,2,66.7,1,33.3,0,0.0
FERRARI,OTHER,1997,2,1,50.0,1,50.0,0,0.0
FERRARI,OTHER,1998,1,1,100.0,0,0.0,0,0.0
FERRARI,OTHER,1999,2,2,100.0,0,0.0,0,0.0
FERRARI,OTHER,2000,1,1,100.0,0,0.0,0,0.0
FERRARI,OTHER,2002,2,2,100.0,0,0.0,0,0.0
FERRARI,OTHER,2004,1,0,0.0,1,100.0,1,100.0
FERRARI,OTHER,2005,1,0,0.0,1,100.0,0,0.0
FERRARI,OTHER,2006,6,3,50.0,3,50.0,1,16.7
FERRARI,OTHER,2007,5,5,100.0,0,0.0,0,0.0
FERRARI,OTHER,2012,6,6,100.0,0,0.0,0,0.0
FERRARI,OTHER,2013,1,1,100.0,0,0.0,0,0.0
FERRARI,OTHER,2014,1,1,100.0,0,0.0,0,0.0
FIAT,126,1980,1,0,0.0,1,100.0,0,0.0
FIAT,126,1983,1,0,0.0,1,100.0,0,0.0
FIAT,126,1989,1,0,0.0,1,100.0,0,0.0
FIAT,126,1990,1,0,0.0,1,100.0,0,0.0
FIAT,127,1980,1,0,0.0,1,100.0,0,0.0
FIAT,500,2008,266,94,35.3,172,64.7,0,0.0
FIAT,500,2009,107,44,41.1,63,58.9,0,0.0
FIAT,500,2010,337,178,52.8,159,47.2,0,0.0
FIAT,500,2011,76,34,44.7,42,55.3,0,0.0
FIAT,500,2012,240,139,57.9,101,42.1,0,0.0
FIAT,500,2013,109,63,57.8,46,42.2,0,0.0
FIAT,500,2014,454,280,61.7,174,38.3,0,0.0
FIAT,500,2015,20,14,70.0,6,30.0,0,0.0
FIAT,500,2016,1,0,0.0,1,100.0,0,0.0
FIAT,500C,2009,2,1,50.0,1,50.0,0,0.0
FIAT,500C,2010,3,1,33.3,2,66.7,0,0.0
FIAT,500C,2011,3,1,33.3,2,66.7,0,0.0
FIAT,500C,2012,6,3,50.0,3,50.0,0,0.0
FIAT,500C,2013,2,1,50.0,1,50.0,0,0.0
FIAT,500C,2014,3,2,66.7,1,33.3,0,0.0
FIAT,500L,2013,6,4,66.7,2,33.3,0,0.0
FIAT,500L,2014,62,33,53.2,29,46.8,0,0.0
FIAT,500L,2015,2,1,50.0,1,50.0,0,0.0
FIAT,500L MPW,2014,17,9,52.9,8,47.1,0,0.0
FIAT,500X,2015,1,0,0.0,1,100.0,0,0.0
FIAT,BARCHETTA,2000,2,1,50.0,1,50.0,0,0.0
FIAT,BRAVA,1996,1,1,100.0,0,0.0,0,0.0
FIAT,BRAVA,1997,1,1,100.0,0,0.0,0,0.0
FIAT,BRAVA,1999,6,2,33.3,4,66.7,0,0.0
FIAT,BRAVA,2000,7,3,42.9,4,57.1,0,0.0
FIAT,BRAVA,2001,16,7,43.8,9,56.3,0,0.0
FIAT,BRAVO,1997,2,2,100.0,0,0.0,0,0.0
FIAT,BRAVO,1998,1,0,0.0,1,100.0,0,0.0
FIAT,BRAVO,1999,2,0,0.0,2,100.0,0,0.0
FIAT,BRAVO,2000,1,1,100.0,0,0.0,0,0.0
FIAT,BRAVO,2001,5,1,20.0,4,80.0,0,0.0
FIAT,BRAVO,2007,89,42,47.2,47,52.8,0,0.0
FIAT,BRAVO,2008,229,101,44.1,128,55.9,0,0.0
FIAT,BRAVO,2009,100,50,50.0,50,50.0,0,0.0
FIAT,BRAVO,2010,114,56,49.1,58,50.9,0,0.0
FIAT,BRAVO,2011,10,8,80.0,2,20.0,0,0.0
FIAT,BRAVO,2012,16,9,56.3,7,43.8,0,0.0
FIAT,BRAVO,2014,1,1,100.0,0,0.0,0,0.0
FIAT,CINQUECENTO,1993,2,2,100.0,0,0.0,0,0.0
FIAT,CINQUECENTO,1995,1,1,100.0,0,0.0,0,0.0
FIAT,CINQUECENTO,1996,12,3,25.0,9,75.0,0,0.0
FIAT,CINQUECENTO,1997,38,14,36.8,24,63.2,0,0.0
FIAT,CINQUECENTO,1998,9,1,11.1,8,88.9,0,0.0
FIAT,COUPE,1996,2,0,0.0,2,100.0,0,0.0
FIAT,COUPE,1997,3,1,33.3,2,66.7,0,0.0
FIAT,COUPE,1998,5,2,40.0,3,60.0,0,0.0
FIAT,COUPE,1999,6,3,50.0,3,50.0,0,0.0
FIAT,COUPE,2000,11,4,36.4,7,63.6,0,0.0
FIAT,COUPE,2001,3,3,100.0,0,0.0,0,0.0
FIAT,CROMA,1987,1,0,0.0,1,100.0,0,0.0
FIAT,CROMA,1989,1,1,100.0,0,0.0,0,0.0
FIAT,CROMA,2005,13,4,30.8,9,69.2,0,0.0
FIAT,CROMA,2006,38,13,34.2,25,65.8,0,0.0
FIAT,CROMA,2007,9,3,33.3,6,66.7,0,0.0
FIAT,CROMA,2008,3,2,66.7,1,33.3,0,0.0
FIAT,CROMA,2010,2,1,50.0,1,50.0,0,0.0
FIAT,DOBLO,2002,2,0,0.0,2,100.0,0,0.0
FIAT,DOBLO,2003,14,0,0.0,14,100.0,0,0.0
FIAT,DOBLO,2004,48,15,31.3,33,68.8,0,0.0
FIAT,DOBLO,2005,123,48,39.0,75,61.0,0,0.0
FIAT,DOBLO,2006,145,61,42.1,84,57.9,0,0.0
FIAT,DOBLO,2007,180,65,36.1,115,63.9,2,1.1
FIAT,DOBLO,2008,144,58,40.3,86,59.7,2,1.4
FIAT,DOBLO,2009,53,28,52.8,25,47.2,1,1.9
FIAT,DOBLO,2010,49,27,55.1,22,44.9,0,0.0
FIAT,DOBLO,2011,14,7,50.0,7,50.0,0,0.0
FIAT,DOBLO,2012,35,23,65.7,12,34.3,0,0.0
FIAT,DOBLO,2013,7,5,71.4,2,28.6,1,14.3
FIAT,DOBLO,2014,8,4,50.0,4,50.0,0,0.0
FIAT,DOBLO,2015,2,2,100.0,0,0.0,0,0.0
FIAT,DUCATO,2003,1,0,0.0,1,100.0,0,0.0
FIAT,DUCATO,2004,1,0,0.0,1,100.0,0,0.0
FIAT,DUCATO,2006,2,1,50.0,1,50.0,0,0.0
FIAT,DUCATO,2012,1,0,0.0,1,100.0,0,0.0
FIAT,DUCATO,2014,2,1,50.0,1,50.0,0,0.0
FIAT,DUCATO 2.2 TDI,2007,2,0,0.0,2,100.0,0,0.0
FIAT,GRANDE PUNTO,2005,5,2,40.0,3,60.0,0,0.0
FIAT,GRANDE PUNTO,2006,1495,633,42.3,862,57.7,0,0.0
FIAT,GRANDE PUNTO,2007,1072,508,47.4,564,52.6,0,0.0
FIAT,GRANDE PUNTO,2008,289,143,49.5,146,50.5,0,0.0
FIAT,GRANDE PUNTO,2009,155,85,54.8,70,45.2,0,0.0
FIAT,GRANDE PUNTO,2010,245,141,57.6,104,42.4,0,0.0
FIAT,GRANDE PUNTO,2011,1,1,100.0,0,0.0,0,0.0
FIAT,IDEA,2004,91,34,37.4,57,62.6,0,0.0
FIAT,IDEA,2005,45,20,44.4,25,55.6,0,0.0
FIAT,IDEA,2006,25,11,44.0,14,56.0,0,0.0
FIAT,IDEA,2007,11,6,54.5,5,45.5,0,0.0
FIAT,IDEA,2008,1,1,100.0,0,0.0,0,0.0
FIAT,MAREA,1997,1,1,100.0,0,0.0,0,0.0
FIAT,MAREA,1998,1,1,100.0,0,0.0,0,0.0
FIAT,MAREA,1999,3,1,33.3,2,66.7,0,0.0
FIAT,MAREA,2000,7,2,28.6,5,71.4,0,0.0
FIAT,MAREA,2001,7,1,14.3,6,85.7,0,0.0
FIAT,MAREA,2002,11,3,27.3,8,72.7,0,0.0
FIAT,MAREA,2003,2,0,0.0,2,100.0,0,0.0
FIAT,MULTIPLA,1999,1,0,0.0,1,100.0,0,0.0
FIAT,MULTIPLA,2000,4,1,25.0,3,75.0,0,0.0
FIAT,MULTIPLA,2001,10,2,20.0,8,80.0,0,0.0
FIAT,MULTIPLA,2002,10,1,10.0,9,90.0,0,0.0
FIAT,MULTIPLA,2003,8,2,25.0,6,75.0,0,0.0
FIAT,MULTIPLA,2004,14,2,14.3,12,85.7,0,0.0
FIAT,MULTIPLA,2005,43,15,34.9,28,65.1,0,0.0
FIAT,MULTIPLA,2006,21,8,38.1,13,61.9,0,0.0
FIAT,MULTIPLA,2007,13,5,38.5,8,61.5,0,0.0
FIAT,MULTIPLA,2008,4,3,75.0,1,25.0,0,0.0
FIAT,MULTIPLA,2009,2,0,0.0,2,100.0,0,0.0
FIAT,MULTIPLA,2010,2,0,0.0,2,100.0,0,0.0
FIAT,OTHER,1980,1,1,100.0,0,0.0,0,0.0
FIAT,OTHER,1990,1,1,100.0,0,0.0,0,0.0
FIAT,OTHER,1992,1,1,100.0,0,0.0,0,0.0
FIAT,OTHER,1993,1,1,100.0,0,0.0,0,0.0
FIAT,OTHER,1995,2,2,100.0,0,0.0,0,0.0
FIAT,OTHER,1996,4,1,25.0,3,75.0,0,0.0
FIAT,OTHER,1997,3,2,66.7,1,33.3,0,0.0
FIAT,OTHER,1998,1,1,100.0,0,0.0,0,0.0
FIAT,OTHER,1999,2,0,0.0,2,100.0,0,0.0
FIAT,OTHER,2000,1,0,0.0,1,100.0,0,0.0
FIAT,OTHER,2002,3,0,0.0,3,100.0,0,0.0
FIAT,OTHER,2003,5,1,20.0,4,80.0,0,0.0
FIAT,OTHER,2004,5,0,0.0,5,100.0,0,0.0
FIAT,OTHER,2005,1,0,0.0,1,100.0,0,0.0
FIAT,OTHER,2006,6,2,33.3,4,66.7,0,0.0
FIAT,OTHER,2007,17,4,23.5,13,76.5,0,0.0
FIAT,OTHER,2008,3,2,66.7,1,33.3,0,0.0
FIAT,OTHER,2009,11,3,27.3,8,72.7,0,0.0
FIAT,OTHER,2010,8,3,37.5,5,62.5,0,0.0
FIAT,OTHER,2011,1,0,0.0,1,100.0,0,0.0
FIAT,OTHER,2012,6,5,83.3,1,16.7,0,0.0
FIAT,OTHER,2014,12,9,75.0,3,25.0,0,0.0
FIAT,PANDA,1981,1,1,100.0,0,0.0,0,0.0
FIAT,PANDA,1989,2,0,0.0,2,100.0,0,0.0
FIAT,PANDA,2003,19,7,36.8,12,63.2,1,5.3
FIAT,PANDA,2004,720,307,42.6,413,57.4,0,0.0
FIAT,PANDA,2005,453,191,42.2,262,57.8,0,0.0
FIAT,PANDA,2006,373,180,48.3,193,51.7,0,0.0
FIAT,PANDA,2007,248,123,49.6,125,50.4,0,0.0
FIAT,PANDA,2008,91,44,48.4,47,51.6,0,0.0
FIAT,PANDA,2009,44,28,63.6,16,36.4,0,0.0
FIAT,PANDA,2010,540,354,65.6,186,34.4,0,0.0
FIAT,PANDA,2011,53,32,60.4,21,39.6,0,0.0
FIAT,PANDA,2012,259,183,70.7,76,29.3,0,0.0
FIAT,PANDA,2013,11,10,90.9,1,9.1,0,0.0
FIAT,PANDA,2014,81,69,85.2,12,14.8,0,0.0
FIAT,PANDA,2015,15,15,100.0,0,0.0,0,0.0
FIAT,PUNTO,1994,1,0,0.0,1,100.0,0,0.0
FIAT,PUNTO,1995,8,4,50.0,4,50.0,0,0.0
FIAT,PUNTO,1996,14,4,28.6,10,71.4,0,0.0
FIAT,PUNTO,1997,23,11,47.8,12,52.2,0,0.0
FIAT,PUNTO,1998,57,30,52.6,27,47.4,0,0.0
FIAT,PUNTO,1999,86,29,33.7,57,66.3,0,0.0
FIAT,PUNTO,2000,286,93,32.5,193,67.5,0,0.0
FIAT,PUNTO,2001,329,113,34.3,216,65.7,0,0.0
FIAT,PUNTO,2002,692,238,34.4,454,65.6,0,0.0
FIAT,PUNTO,2003,871,299,34.3,572,65.7,0,0.0
FIAT,PUNTO,2004,999,329,32.9,670,67.1,0,0.0
FIAT,PUNTO,2005,735,320,43.5,415,56.5,1,0.1
FIAT,PUNTO,2006,101,37,36.6,64,63.4,0,0.0
FIAT,PUNTO,2007,64,24,37.5,40,62.5,0,0.0
FIAT,PUNTO,2008,34,17,50.0,17,50.0,0,0.0
FIAT,PUNTO,2009,5,2,40.0,3,60.0,0,0.0
FIAT,PUNTO,2010,124,90,72.6,34,27.4,0,0.0
FIAT,PUNTO,2011,33,23,69.7,10,30.3,0,0.0
FIAT,PUNTO,2012,142,96,67.6,46,32.4,0,0.0
FIAT,PUNTO,2013,10,6,60.0,4,40.0,0,0.0
FIAT,PUNTO,2014,121,101,83.5,20,16.5,0,0.0
FIAT,PUNTO,2015,7,4,57.1,3,42.9,0,0.0
FIAT,PUNTO EVO,2010,18,11,61.1,7,38.9,0,0.0
FIAT,PUNTO EVO,2011,14,9,64.3,5,35.7,0,0.0
FIAT,PUNTO EVO,2012,4,2,50.0,2,50.0,0,0.0
FIAT,QUBO,2008,2,2,100.0,0,0.0,0,0.0
FIAT,QUBO,2009,20,7,35.0,13,65.0,0,0.0
FIAT,QUBO,2010,30,13,43.3,17,56.7,0,0.0
FIAT,QUBO,2011,6,4,66.7,2,33.3,0,0.0
FIAT,QUBO,2012,23,15,65.2,8,34.8,0,0.0
FIAT,QUBO,2013,6,6,100.0,0,0.0,0,0.0
FIAT,QUBO,2014,10,7,70.0,3,30.0,0,0.0
FIAT,QUBO,2015,3,3,100.0,0,0.0,0,0.0
FIAT,REGATA,1986,1,0,0.0,1,100.0,0,0.0
FIAT,RITMO,1988,1,1,100.0,0,0.0,0,0.0
FIAT,SCUDO,1999,13,4,30.8,9,69.2,0,0.0
FIAT,SCUDO,2000,13,1,7.7,12,92.3,0,0.0
FIAT,SCUDO,2001,15,4,26.7,11,73.3,0,0.0
FIAT,SCUDO,2002,10,4,40.0,6,60.0,0,0.0
FIAT,SCUDO,2003,16,4,25.0,12,75.0,0,0.0
FIAT,SCUDO,2004,39,15,38.5,24,61.5,0,0.0
FIAT,SCUDO,2005,30,9,30.0,21,70.0,0,0.0
FIAT,SCUDO,2006,24,6,25.0,18,75.0,0,0.0
FIAT,SCUDO,2007,78,22,28.2,56,71.8,0,0.0
FIAT,SCUDO,2008,66,24,36.4,42,63.6,1,1.5
FIAT,SCUDO,2009,16,3,18.8,13,81.3,0,0.0
FIAT,SCUDO,2010,15,6,40.0,9,60.0,0,0.0
FIAT,SCUDO,2011,15,3,20.0,12,80.0,0,0.0
FIAT,SCUDO,2012,1,0,0.0,1,100.0,0,0.0
FIAT,SCUDO,2013,3,2,66.7,1,33.3,0,0.0
FIAT,SCUDO,2014,3,1,33.3,2,66.7,1,33.3
FIAT,SCUDO,2015,1,0,0.0,1,100.0,0,0.0
FIAT,SCUDO 2.0 PANORAMA 5DR,2007,2,1,50.0,1,50.0,0,0.0
FIAT,SCUDO LWB MJET 5DR,2008,1,0,0.0,1,100.0,0,0.0
FIAT,SCUDO SWB COMFORT MJET 90 5DR,2008,1,0,0.0,1,100.0,0,0.0
FIAT,SEDICI,2006,22,12,54.5,10,45.5,0,0.0
FIAT,SEDICI,2007,95,45,47.4,50,52.6,0,0.0
FIAT,SEDICI,2008,58,33,56.9,25,43.1,0,0.0
FIAT,SEDICI,2009,2,2,100.0,0,0.0,0,0.0
FIAT,SEDICI,2010,3,2,66.7,1,33.3,0,0.0
FIAT,SEDICI,2011,1,1,100.0,0,0.0,0,0.0
FIAT,SEICENTO,1998,9,1,11.1,8,88.9,0,0.0
FIAT,SEICENTO,1999,53,15,28.3,38,71.7,0,0.0
FIAT,SEICENTO,2000,158,62,39.2,96,60.8,0,0.0
FIAT,SEICENTO,2001,91,40,44.0,51,56.0,1,1.1
FIAT,SEICENTO,2002,60,20,33.3,40,66.7,0,0.0
FIAT,SEICENTO,2003,44,14,31.8,30,68.2,0,0.0
FIAT,SEICENTO,2004,3,1,33.3,2,66.7,0,0.0
FIAT,SIENA 1.2 EL LHD,2002,1,1,100.0,0,0.0,0,0.0
FIAT,STILO,2001,2,0,0.0,2,100.0,0,0.0
FIAT,STILO,2002,179,45,25.1,134,74.9,0,0.0
FIAT,STILO,2003,186,55,29.6,131,70.4,0,0.0
FIAT,STILO,2004,126,19,15.1,107,84.9,0,0.0
FIAT,STILO,2005,154,59,38.3,95,61.7,0,0.0
FIAT,STILO,2006,97,30,30.9,67,69.1,0,0.0
FIAT,STILO,2007,38,14,36.8,24,63.2,0,0.0
FIAT,TEMPRA,1994,1,0,0.0,1,100.0,0,0.0
FIAT,TIPO,1993,4,1,25.0,3,75.0,0,0.0
FIAT,TIPO,1994,1,0,0.0,1,100.0,0,0.0
FIAT,TIPO,1995,1,0,0.0,1,100.0,0,0.0
FIAT,TIPO,2017,4,3,75.0,1,25.0,0,0.0
FIAT,ULYSSE,1999,1,0,0.0,1,100.0,0,0.0
FIAT,ULYSSE,2002,1,0,0.0,1,100.0,0,0.0
FIAT,ULYSSE,2003,2,0,0.0,2,100.0,0,0.0
FIAT,ULYSSE,2004,10,0,0.0,10,100.0,0,0.0
FIAT,ULYSSE,2005,2,1,50.0,1,50.0,0,0.0
FIAT,ULYSSE,2007,1,0,0.0,1,100.0,0,0.0
FIAT,UNO,1988,1,1,100.0,0,0.0,0,0.0
FIAT,UNO,1989,3,2,66.7,1,33.3,0,0.0
FIAT,UNO,1990,1,0,0.0,1,100.0,0,0.0
FIAT,UNO,1991,1,0,0.0,1,100.0,0,0.0
FIAT,UNO,1993,2,0,0.0,2,100.0,0,0.0
FISKER,OTHER,2012,1,1,100.0,0,0.0,0,0.0
FORD,B-MAX,2012,13,11,84.6,2,15.4,0,0.0
FORD,B-MAX,2013,43,33,76.7,10,23.3,0,0.0
FORD,B-MAX,2014,164,126,76.8,38,23.2,0,0.0
FORD,B-MAX,2015,13,9,69.2,4,30.8,0,0.0
FORD,C MAX,2004,3,1,33.3,2,66.7,0,0.0
FORD,C MAX,2005,2,0,0.0,2,100.0,0,0.0
FORD,C MAX,2006,5,1,20.0,4,80.0,0,0.0
FORD,C MAX,2007,35,14,40.0,21,60.0,0,0.0
FORD,C MAX,2008,149,46,30.9,103,69.1,0,0.0
FORD,C MAX,2009,55,15,27.3,40,72.7,0,0.0
FORD,C MAX,2010,164,65,39.6,99,60.4,0,0.0
FORD,C MAX,2011,136,99,72.8,37,27.2,0,0.0
FORD,C MAX,2012,466,350,75.1,116,24.9,1,0.2
FORD,C MAX,2013,96,70,72.9,26,27.1,0,0.0
FORD,C MAX,2014,519,416,80.2,103,19.8,0,0.0
FORD,C MAX,2015,65,53,81.5,12,18.5,0,0.0
FORD,C MAX,2016,1,1,100.0,0,0.0,0,0.0
FORD,C MAX,2017,1,1,100.0,0,0.0,0,0.0
FORD,CAPRI,1981,3,2,66.7,1,33.3,0,0.0
FORD,CAPRI,1982,3,0,0.0,3,100.0,0,0.0
FORD,CAPRI,1983,6,3,50.0,3,50.0,0,0.0
FORD,CAPRI,1984,9,3,33.3,6,66.7,0,0.0
FORD,CAPRI,1985,6,4,66.7,2,33.3,0,0.0
FORD,CAPRI,1986,12,1,8.3,11,91.7,0,0.0
FORD,CAPRI,1987,13,3,23.1,10,76.9,0,0.0
FORD,CAPRI,1990,1,0,0.0,1,100.0,0,0.0
FORD,CONSUL,2004,1,1,100.0,0,0.0,0,0.0
FORD,CORTINA,1976,1,1,100.0,0,0.0,0,0.0
FORD,CORTINA,1977,1,0,0.0,1,100.0,0,0.0
FORD,CORTINA,1980,4,2,50.0,2,50.0,0,0.0
FORD,CORTINA,1981,4,2,50.0,2,50.0,0,0.0
FORD,CORTINA,1982,9,4,44.4,5,55.6,0,0.0
FORD,CORTINA,1983,1,1,100.0,0,0.0,0,0.0
FORD,COUGAR,1999,4,1,25.0,3,75.0,0,0.0
FORD,COUGAR,2000,4,0,0.0,4,100.0,0,0.0
FORD,COUGAR,2001,4,3,75.0,1,25.0,0,0.0
FORD,ECOSPORT,2014,87,68,78.2,19,21.8,0,0.0
FORD,ECOSPORT,2015,21,15,71.4,6,28.6,0,0.0
FORD,ESCORT,1980,7,5,71.4,2,28.6,0,0.0
FORD,ESCORT,1981,1,0,0.0,1,100.0,0,0.0
FORD,ESCORT,1982,6,3,50.0,3,50.0,0,0.0
FORD,ESCORT,1983,4,2,50.0,2,50.0,0,0.0
FORD,ESCORT,1984,2,2,100.0,0,0.0,0,0.0
FORD,ESCORT,1985,3,0,0.0,3,100.0,0,0.0
FORD,ESCORT,1986,3,2,66.7,1,33.3,0,0.0
FORD,ESCORT,1987,4,2,50.0,2,50.0,0,0.0
FORD,ESCORT,1988,10,4,40.0,6,60.0,0,0.0
FORD,ESCORT,1989,10,5,50.0,5,50.0,0,0.0
FORD,ESCORT,1990,18,11,61.1,7,38.9,0,0.0
FORD,ESCORT,1991,5,1,20.0,4,80.0,0,0.0
FORD,ESCORT,1992,11,5,45.5,6,54.5,0,0.0
FORD,ESCORT,1993,3,1,33.3,2,66.7,0,0.0
FORD,ESCORT,1994,10,1,10.0,9,90.0,1,10.0
FORD,ESCORT,1995,13,2,15.4,11,84.6,2,15.4
FORD,ESCORT,1996,30,10,33.3,20,66.7,0,0.0
FORD,ESCORT,1997,39,13,33.3,26,66.7,0,0.0
FORD,ESCORT,1998,31,9,29.0,22,71.0,0,0.0
FORD,ESCORT,1999,12,5,41.7,7,58.3,0,0.0
FORD,ESCORT,2000,45,14,31.1,31,68.9,0,0.0
FORD,ESCORT,2001,4,1,25.0,3,75.0,0,0.0
FORD,ESCORT MK 1 RS 2000,2013,1,1,100.0,0,0.0,0,0.0
FORD,ESCORT RS COSWORTH,1995,2,1,50.0,1,50.0,0,0.0
FORD,ESCORT RS TURBO,1980,1,0,0.0,1,100.0,0,0.0
FORD,ESCORT RS TURBO,1988,1,0,0.0,1,100.0,0,0.0
FORD,ESCORT RS TURBO,1990,1,1,100.0,0,0.0,0,0.0
FORD,ESCORT RS TURBO,1993,3,2,66.7,1,33.3,0,0.0
FORD,ESCORT RS TURBO,1994,2,1,50.0,1,50.0,0,0.0
FORD,ESCORT RS TURBO,1996,1,1,100.0,0,0.0,0,0.0
FORD,FIESTA,1980,2,1,50.0,1,50.0,0,0.0
FORD,FIESTA,1981,3,2,66.7,1,33.3,0,0.0
FORD,FIESTA,1982,4,3,75.0,1,25.0,0,0.0
FORD,FIESTA,1983,9,5,55.6,4,44.4,0,0.0
FORD,FIESTA,1984,5,2,40.0,3,60.0,0,0.0
FORD,FIESTA,1985,7,3,42.9,4,57.1,0,0.0
FORD,FIESTA,1986,5,3,60.0,2,40.0,0,0.0
FORD,FIESTA,1988,11,4,36.4,7,63.6,0,0.0
FORD,FIESTA,1989,15,4,26.7,11,73.3,0,0.0
FORD,FIESTA,1990,12,6,50.0,6,50.0,0,0.0
FORD,FIESTA,1991,4,2,50.0,2,50.0,0,0.0
FORD,FIESTA,1992,10,6,60.0,4,40.0,0,0.0
FORD,FIESTA,1993,3,1,33.3,2,66.7,0,0.0
FORD,FIESTA,1994,5,2,40.0,3,60.0,0,0.0
FORD,FIESTA,1995,10,3,30.0,7,70.0,0,0.0
FORD,FIESTA,1996,56,21,37.5,35,62.5,0,0.0
FORD,FIESTA,1997,181,58,32.0,123,68.0,0,0.0
FORD,FIESTA,1998,278,65,23.4,213,76.6,0,0.0
FORD,FIESTA,1999,430,110,25.6,320,74.4,0,0.0
FORD,FIESTA,2000,756,211,27.9,545,72.1,0,0.0
FORD,FIESTA,2001,573,152,26.5,421,73.5,0,0.0
FORD,FIESTA,2002,1044,316,30.3,728,69.7,0,0.0
FORD,FIESTA,2003,2696,1006,37.3,1690,62.7,0,0.0
FORD,FIESTA,2004,3077,1229,39.9,1848,60.1,1,0.0
FORD,FIESTA,2005,3750,1556,41.5,2194,58.5,1,0.0
FORD,FIESTA,2006,4197,1981,47.2,2216,52.8,0,0.0
FORD,FIESTA,2007,3388,1734,51.2,1654,48.8,0,0.0
FORD,FIESTA,2008,1348,702,52.1,646,47.9,0,0.0
FORD,FIESTA,2009,1500,839,55.9,661,44.1,1,0.1
FORD,FIESTA,2010,3553,2127,59.9,1426,40.1,2,0.1
FORD,FIESTA,2011,603,386,64.0,217,36.0,0,0.0
FORD,FIESTA,2012,2135,1615,75.6,520,24.4,2,0.1
FORD,FIESTA,2013,445,336,75.5,109,24.5,0,0.0
FORD,FIESTA,2014,2876,2389,83.1,487,16.9,0,0.0
FORD,FIESTA,2015,404,353,87.4,51,12.6,0,0.0
FORD,FIESTA,2016,5,2,40.0,3,60.0,0,0.0
FORD,FIESTA 1.25 16V STYLE,2006,2,1,50.0,1,50.0,0,0.0
FORD,FIESTA 1.25 16V STYLE,2007,2,1,50.0,1,50.0,0,0.0
FORD,FIESTA 1.25 FINESSE 5DR,2004,1,0,0.0,1,100.0,0,0.0
FORD,FIESTA 1.25 LX 5DR,2004,1,0,0.0,1,100.0,0,0.0
FORD,FIESTA 1.25 STYLE CLIMATE 5 DR,2006,1,0,0.0,1,100.0,0,0.0
FORD,FIESTA 1.25 STYLE CLIMATE 5 DR,2008,1,1,100.0,0,0.0,0,0.0
FORD,FIESTA 1.25 ZETEC,1999,1,0,0.0,1,100.0,0,0.0
FORD,FIESTA 1.25 ZETEC,2005,3,2,66.7,1,33.3,0,0.0
FORD,FIESTA 1.25 ZETEC,2006,2,1,50.0,1,50.0,0,0.0
FORD,FIESTA 1.25 ZETEC,2007,4,0,0.0,4,100.0,0,0.0
FORD,FIESTA 1.25 ZETEC,2008,1,0,0.0,1,100.0,0,0.0
FORD,FIESTA 1.25 ZETEC,2010,2,1,50.0,1,50.0,0,0.0
FORD,FIESTA 1.25 ZETEC,2011,2,0,0.0,2,100.0,0,0.0
FORD,FIESTA 1.25 ZETEC,2012,1,1,100.0,0,0.0,0,0.0
FORD,FIESTA 1.25 ZETEC,2013,1,0,0.0,1,100.0,0,0.0
FORD,FIESTA 1.25 ZETEC 82PS 3DR,2009,1,1,100.0,0,0.0,0,0.0
FORD,FIESTA 1.25 ZETEC 82PS 3DR,2010,1,0,0.0,1,100.0,0,0.0
FORD,FIESTA 1.5 TDCI,2012,1,1,100.0,0,0.0,0,0.0
FORD,FIESTA 1.5 TDCI,2013,2,1,50.0,1,50.0,0,0.0
FORD,FIESTA 1.5 TDCI,2014,3,3,100.0,0,0.0,0,0.0
FORD,FIESTA ARGENTO 1.25,1996,1,1,100.0,0,0.0,0,0.0
FORD,FIESTA ARGENTO 1.25,1997,1,0,0.0,1,100.0,0,0.0
FORD,FIESTA ARGENTO 1.25,1998,3,0,0.0,3,100.0,0,0.0
FORD,FIESTA ARGENTO 1.25,1999,3,0,0.0,3,100.0,0,0.0
FORD,FIESTA ARGENTO 1.25,2000,1,0,0.0,1,100.0,0,0.0
FORD,FIESTA ARGENTO 1.25,2001,11,5,45.5,6,54.5,0,0.0
FORD,FIESTA ARGENTO 1.25,2002,4,0,0.0,4,100.0,0,0.0
FORD,FIESTA ARGENTO 1.25,2003,24,10,41.7,14,58.3,0,0.0
FORD,FIESTA ARGENTO 1.25,2004,101,41,40.6,60,59.4,0,0.0
FORD,FIESTA ARGENTO 1.25,2005,88,29,33.0,59,67.0,0,0.0
FORD,FIESTA ARGENTO 1.25,2006,168,58,34.5,110,65.5,0,0.0
FORD,FIESTA ARGENTO 1.25,2007,175,81,46.3,94,53.7,2,1.1
FORD,FIESTA ARGENTO 1.25,2008,141,78,55.3,63,44.7,0,0.0
FORD,FIESTA ARGENTO 1.25,2009,163,83,50.9,80,49.1,0,0.0
FORD,FIESTA ARGENTO 1.25,2010,200,111,55.5,89,44.5,1,0.5
FORD,FIESTA ARGENTO 1.25,2011,131,84,64.1,47,35.9,0,0.0
FORD,FIESTA ARGENTO 1.25,2012,227,169,74.4,58,25.6,0,0.0
FORD,FIESTA ARGENTO 1.25,2013,63,51,81.0,12,19.0,0,0.0
FORD,FIESTA ARGENTO 1.25,2014,176,143,81.3,33,18.8,1,0.6
FORD,FIESTA ARGENTO 1.25,2015,7,6,85.7,1,14.3,0,0.0
FORD,FIESTA ARGENTO 1.25,2016,1,1,100.0,0,0.0,0,0.0
FORD,FIESTA FINESSE,2003,1,1,100.0,0,0.0,0,0.0
FORD,FIESTA FINESSE,2004,1,0,0.0,1,100.0,0,0.0
FORD,FOCUS,1998,3,1,33.3,2,66.7,0,0.0
FORD,FOCUS,1999,461,153,33.2,308,66.8,0,0.0
FORD,FOCUS,2000,1348,363,26.9,985,73.1,0,0.0
FORD,FOCUS,2001,1605,486,30.3,1119,69.7,0,0.0
FORD,FOCUS,2002,2730,743,27.2,1987,72.8,1,0.0
FORD,FOCUS,2003,3594,1030,28.7,2564,71.3,0,0.0
FORD,FOCUS,2004,5380,1957,36.4,3423,63.6,1,0.0
FORD,FOCUS,2005,9826,3856,39.2,5970,60.8,4,0.0
FORD,FOCUS,2006,10182,4241,41.7,5941,58.3,1,0.0
FORD,FOCUS,2007,9357,4058,43.4,5299,56.6,1,0.0
FORD,FOCUS,2008,7848,3005,38.3,4843,61.7,3,0.0
FORD,FOCUS,2009,3571,1514,42.4,2057,57.6,5,0.1
FORD,FOCUS,2010,6431,3005,46.7,3426,53.3,6,0.1
FORD,FOCUS,2011,1718,1012,58.9,706,41.1,3,0.2
FORD,FOCUS,2012,5424,3950,72.8,1474,27.2,1,0.0
FORD,FOCUS,2013,1420,1078,75.9,342,24.1,0,0.0
FORD,FOCUS,2014,5640,4742,84.1,898,15.9,4,0.1
FORD,FOCUS,2015,495,436,88.1,59,11.9,1,0.2
FORD,FOCUS,2016,37,22,59.5,15,40.5,0,0.0
FORD,FOCUS,2017,1,1,100.0,0,0.0,0,0.0
FORD,FOCUS,2018,2,1,50.0,1,50.0,0,0.0
FORD,FOCUS 1.4 LX 74 BHP 5DR,2004,1,0,0.0,1,100.0,0,0.0
FORD,FOCUS 1.4 LX 79BHP 5DR,2007,1,1,100.0,0,0.0,0,0.0
FORD,FOCUS 1.6 ZETEC 99BHP 5DR,2005,1,0,0.0,1,100.0,0,0.0
FORD,FOCUS 1.6TDCI ZETEC CLIMATE 5D,2006,1,0,0.0,1,100.0,0,0.0
FORD,FOCUS C-MAX,2003,2,0,0.0,2,100.0,0,0.0
FORD,FOCUS C-MAX,2004,119,33,27.7,86,72.3,0,0.0
FORD,FOCUS C-MAX,2005,101,30,29.7,71,70.3,0,0.0
FORD,FOCUS C-MAX,2006,81,29,35.8,52,64.2,0,0.0
FORD,FOCUS C-MAX,2007,632,243,38.4,389,61.6,0,0.0
FORD,FOCUS C-MAX,2008,142,41,28.9,101,71.1,0,0.0
FORD,FOCUS C-MAX,2009,12,7,58.3,5,41.7,0,0.0
FORD,FOCUS C-MAX,2010,1,0,0.0,1,100.0,0,0.0
FORD,FOCUS C-MAX 1.6 ZETEC 99BHP 5D,2004,2,0,0.0,2,100.0,0,0.0
FORD,FOCUS C-MAX 1.6TDCI ZETEC 5DR,2005,1,0,0.0,1,100.0,0,0.0
FORD,FUSION,2002,13,6,46.2,7,53.8,0,0.0
FORD,FUSION,2003,600,194,32.3,406,67.7,0,0.0
FORD,FUSION,2004,300,93,31.0,207,69.0,0,0.0
FORD,FUSION,2005,259,110,42.5,149,57.5,0,0.0
FORD,FUSION,2006,449,193,43.0,256,57.0,0,0.0
FORD,FUSION,2007,466,218,46.8,248,53.2,0,0.0
FORD,FUSION,2008,193,88,45.6,105,54.4,0,0.0
FORD,FUSION,2009,94,47,50.0,47,50.0,0,0.0
FORD,FUSION,2010,108,60,55.6,48,44.4,0,0.0
FORD,FUSION,2011,6,3,50.0,3,50.0,0,0.0
FORD,FUSION,2012,1,0,0.0,1,100.0,0,0.0
FORD,FUSION 1.6 5DR,2004,1,1,100.0,0,0.0,0,0.0
FORD,GALAXY,1997,3,0,0.0,3,100.0,0,0.0
FORD,GALAXY,1998,3,1,33.3,2,66.7,0,0.0
FORD,GALAXY,1999,3,1,33.3,2,66.7,0,0.0
FORD,GALAXY,2000,10,1,10.0,9,90.0,0,0.0
FORD,GALAXY,2001,54,16,29.6,38,70.4,0,0.0
FORD,GALAXY,2002,143,25,17.5,118,82.5,0,0.0
FORD,GALAXY,2003,283,50,17.7,233,82.3,0,0.0
FORD,GALAXY,2004,452,93,20.6,359,79.4,0,0.0
FORD,GALAXY,2005,555,114,20.5,441,79.5,0,0.0
FORD,GALAXY,2006,590,140,23.7,450,76.3,0,0.0
FORD,GALAXY,2007,1097,396,36.1,701,63.9,0,0.0
FORD,GALAXY,2008,896,317,35.4,579,64.6,0,0.0
FORD,GALAXY,2009,208,66,31.7,142,68.3,0,0.0
FORD,GALAXY,2010,605,256,42.3,349,57.7,0,0.0
FORD,GALAXY,2011,112,59,52.7,53,47.3,0,0.0
FORD,GALAXY,2012,628,324,51.6,304,48.4,0,0.0
FORD,GALAXY,2013,97,66,68.0,31,32.0,0,0.0
FORD,GALAXY,2014,434,300,69.1,134,30.9,1,0.2
FORD,GALAXY,2015,21,12,57.1,9,42.9,0,0.0
FORD,GALAXY,2016,4,3,75.0,1,25.0,0,0.0
FORD,GALAXY,2017,3,2,66.7,1,33.3,0,0.0
FORD,GALAXY 1.9 TDI LHD 87BHP 5DR,1999,1,0,0.0,1,100.0,0,0.0
FORD,GRANADA,1981,1,0,0.0,1,100.0,0,0.0
FORD,GRANADA,1984,5,0,0.0,5,100.0,0,0.0
FORD,GRANADA,1985,2,2,100.0,0,0.0,0,0.0
FORD,GRANADA,1987,1,1,100.0,0,0.0,0,0.0
FORD,GRANADA,1989,1,0,0.0,1,100.0,0,0.0
FORD,GRANADA,1991,3,3,100.0,0,0.0,0,0.0
FORD,GRANADA,1992,8,5,62.5,3,37.5,0,0.0
FORD,GRANADA,1993,3,2,66.7,1,33.3,0,0.0
FORD,GRANADA,1994,3,3,100.0,0,0.0,0,0.0
FORD,GRAND C-MAX,2010,7,3,42.9,4,57.1,0,0.0
FORD,GRAND C-MAX,2011,88,55,62.5,33,37.5,0,0.0
FORD,GRAND C-MAX,2012,211,139,65.9,72,34.1,0,0.0
FORD,GRAND C-MAX,2013,37,22,59.5,15,40.5,0,0.0
FORD,GRAND C-MAX,2014,180,133,73.9,47,26.1,0,0.0
FORD,GRAND C-MAX,2015,7,6,85.7,1,14.3,0,0.0
FORD,GRAND C-MAX,2016,2,2,100.0,0,0.0,0,0.0
FORD,GRAND C-MAX,2018,1,0,0.0,1,100.0,0,0.0
FORD,KA,1997,5,2,40.0,3,60.0,0,0.0
FORD,KA,1998,3,0,0.0,3,100.0,0,0.0
FORD,KA,1999,8,3,37.5,5,62.5,0,0.0
FORD,KA,2000,38,9,23.7,29,76.3,0,0.0
FORD,KA,2001,70,14,20.0,56,80.0,0,0.0
FORD,KA,2002,110,23,20.9,87,79.1,0,0.0
FORD,KA,2003,105,23,21.9,82,78.1,0,0.0
FORD,KA,2004,129,47,36.4,82,63.6,0,0.0
FORD,KA,2005,132,40,30.3,92,69.7,0,0.0
FORD,KA,2006,162,55,34.0,107,66.0,0,0.0
FORD,KA,2007,151,52,34.4,99,65.6,0,0.0
FORD,KA,2008,64,24,37.5,40,62.5,0,0.0
FORD,KA,2009,131,82,62.6,49,37.4,0,0.0
FORD,KA,2010,711,398,56.0,313,44.0,0,0.0
FORD,KA,2011,43,24,55.8,19,44.2,0,0.0
FORD,KA,2012,77,61,79.2,16,20.8,0,0.0
FORD,KA,2013,41,30,73.2,11,26.8,0,0.0
FORD,KA,2014,78,69,88.5,9,11.5,0,0.0
FORD,KA,2015,14,11,78.6,3,21.4,0,0.0
FORD,KA 3,2000,3,0,0.0,3,100.0,0,0.0
FORD,KA2,1997,6,1,16.7,5,83.3,0,0.0
FORD,KA2,1998,7,3,42.9,4,57.1,0,0.0
FORD,KA2,1999,23,8,34.8,15,65.2,0,0.0
FORD,KA2,2000,11,3,27.3,8,72.7,0,0.0
FORD,KUGA,2008,153,85,55.6,68,44.4,0,0.0
FORD,KUGA,2009,130,57,43.8,73,56.2,1,0.8
FORD,KUGA,2010,557,295,53.0,262,47.0,0,0.0
FORD,KUGA,2011,82,50,61.0,32,39.0,0,0.0
FORD,KUGA,2012,294,199,67.7,95,32.3,0,0.0
FORD,KUGA,2013,67,49,73.1,18,26.9,0,0.0
FORD,KUGA,2014,469,371,79.1,98,20.9,0,0.0
FORD,KUGA,2015,59,53,89.8,6,10.2,0,0.0
FORD,KUGA,2016,2,2,100.0,0,0.0,0,0.0
FORD,KUGA,2017,1,1,100.0,0,0.0,0,0.0
FORD,MAVERICK,1998,1,0,0.0,1,100.0,0,0.0
FORD,MAVERICK,2002,1,1,100.0,0,0.0,0,0.0
FORD,MONDEO,1993,1,0,0.0,1,100.0,0,0.0
FORD,MONDEO,1994,3,1,33.3,2,66.7,0,0.0
FORD,MONDEO,1995,7,1,14.3,6,85.7,0,0.0
FORD,MONDEO,1996,15,2,13.3,13,86.7,0,0.0
FORD,MONDEO,1997,21,5,23.8,16,76.2,0,0.0
FORD,MONDEO,1998,40,13,32.5,27,67.5,0,0.0
FORD,MONDEO,1999,39,7,17.9,32,82.1,0,0.0
FORD,MONDEO,2000,83,17,20.5,66,79.5,0,0.0
FORD,MONDEO,2001,190,58,30.5,132,69.5,0,0.0
FORD,MONDEO,2002,330,113,34.2,217,65.8,0,0.0
FORD,MONDEO,2003,445,115,25.8,330,74.2,0,0.0
FORD,MONDEO,2004,820,228,27.8,592,72.2,1,0.1
FORD,MONDEO,2005,1226,380,31.0,846,69.0,0,0.0
FORD,MONDEO,2006,1386,436,31.5,950,68.5,0,0.0
FORD,MONDEO,2007,2454,945,38.5,1509,61.5,0,0.0
FORD,MONDEO,2008,4818,1879,39.0,2939,61.0,3,0.1
FORD,MONDEO,2009,1335,562,42.1,773,57.9,0,0.0
FORD,MONDEO,2010,2839,1374,48.4,1465,51.6,2,0.1
FORD,MONDEO,2011,766,408,53.3,358,46.7,0,0.0
FORD,MONDEO,2012,2021,1169,57.8,852,42.2,0,0.0
FORD,MONDEO,2013,446,311,69.7,135,30.3,0,0.0
FORD,MONDEO,2014,1585,1218,76.8,367,23.2,0,0.0
FORD,MONDEO,2015,256,215,84.0,41,16.0,0,0.0
FORD,MONDEO,2016,57,47,82.5,10,17.5,0,0.0
FORD,MONDEO,2017,17,16,94.1,1,5.9,0,0.0
FORD,MONDEO,2018,3,2,66.7,1,33.3,0,0.0
FORD,MONDEO LX,2005,1,0,0.0,1,100.0,0,0.0
FORD,MONDEO LX,2008,7,2,28.6,5,71.4,0,0.0
FORD,MONDEO LX,2009,2,1,50.0,1,50.0,0,0.0
FORD,MONDEO LX,2010,1,0,0.0,1,100.0,0,0.0
FORD,ORION,1989,2,1,50.0,1,50.0,0,0.0
FORD,ORION,1990,1,0,0.0,1,100.0,0,0.0
FORD,ORION,1992,2,0,0.0,2,100.0,0,0.0
FORD,ORION,1993,1,0,0.0,1,100.0,0,0.0
FORD,OTHER,1986,1,1,100.0,0,0.0,0,0.0
FORD,OTHER,1989,3,2,66.7,1,33.3,0,0.0
FORD,OTHER,1993,3,1,33.3,2,66.7,0,0.0
FORD,OTHER,1994,2,2,100.0,0,0.0,0,0.0
FORD,OTHER,1995,2,1,50.0,1,50.0,0,0.0
FORD,OTHER,1996,1,1,100.0,0,0.0,0,0.0
FORD,OTHER,1997,5,3,60.0,2,40.0,0,0.0
FORD,OTHER,1998,9,3,33.3,6,66.7,0,0.0
FORD,OTHER,1999,3,0,0.0,3,100.0,0,0.0
FORD,OTHER,2000,3,1,33.3,2,66.7,0,0.0
FORD,OTHER,2001,6,0,0.0,6,100.0,0,0.0
FORD,OTHER,2002,73,21,28.8,52,71.2,0,0.0
FORD,OTHER,2003,239,89,37.2,150,62.8,0,0.0
FORD,OTHER,2004,107,40,37.4,67,62.6,0,0.0
FORD,OTHER,2005,50,19,38.0,31,62.0,0,0.0
FORD,OTHER,2006,46,16,34.8,30,65.2,0,0.0
FORD,OTHER,2007,57,22,38.6,35,61.4,0,0.0
FORD,OTHER,2008,37,20,54.1,17,45.9,1,2.7
FORD,OTHER,2009,6,1,16.7,5,83.3,0,0.0
FORD,OTHER,2010,6,3,50.0,3,50.0,0,0.0
FORD,OTHER,2011,5,3,60.0,2,40.0,0,0.0
FORD,OTHER,2012,11,4,36.4,7,63.6,0,0.0
FORD,OTHER,2013,1,0,0.0,1,100.0,0,0.0
FORD,OTHER,2014,7,5,71.4,2,28.6,0,0.0
FORD,OTHER,2015,2,1,50.0,1,50.0,0,0.0
FORD,OTHER,2016,1,1,100.0,0,0.0,0,0.0
FORD,OTHER,2017,1,1,100.0,0,0.0,0,0.0
FORD,OTHER,2018,1,0,0.0,1,100.0,0,0.0
FORD,PROBE,1993,1,0,0.0,1,100.0,0,0.0
FORD,PROBE,1997,2,1,50.0,1,50.0,0,0.0
FORD,PUMA,1998,7,1,14.3,6,85.7,0,0.0
FORD,PUMA,1999,19,9,47.4,10,52.6,0,0.0
FORD,PUMA,2000,67,14,20.9,53,79.1,0,0.0
FORD,PUMA,2001,49,13,26.5,36,73.5,0,0.0
FORD,PUMA,2002,28,5,17.9,23,82.1,0,0.0
FORD,RANGER,2002,1,0,0.0,1,100.0,0,0.0
FORD,SCORPIO,1991,1,0,0.0,1,100.0,0,0.0
FORD,SCORPIO,1995,1,0,0.0,1,100.0,0,0.0
FORD,SCORPIO,1996,7,5,71.4,2,28.6,0,0.0
FORD,SCORPIO,1997,9,5,55.6,4,44.4,0,0.0
FORD,SCORPIO,1998,10,3,30.0,7,70.0,0,0.0
FORD,SIERRA,1983,4,3,75.0,1,25.0,0,0.0
FORD,SIERRA,1984,2,2,100.0,0,0.0,0,0.0
FORD,SIERRA,1985,3,2,66.7,1,33.3,0,0.0
FORD,SIERRA,1986,5,1,20.0,4,80.0,0,0.0
FORD,SIERRA,1987,3,1,33.3,2,66.7,0,0.0
FORD,SIERRA,1988,8,4,50.0,4,50.0,0,0.0
FORD,SIERRA,1989,16,10,62.5,6,37.5,0,0.0
FORD,SIERRA,1990,26,14,53.8,12,46.2,0,0.0
FORD,SIERRA,1991,27,9,33.3,18,66.7,0,0.0
FORD,SIERRA,1992,52,11,21.2,41,78.8,1,1.9
FORD,SIERRA,1993,16,6,37.5,10,62.5,0,0.0
FORD,SIERRA RS COSWORTH,1987,1,1,100.0,0,0.0,0,0.0
FORD,SIERRA RS COSWORTH RALLY 4DR,1993,1,0,0.0,1,100.0,0,0.0
FORD,S-MAX,2006,279,80,28.7,199,71.3,0,0.0
FORD,S-MAX,2007,916,328,35.8,588,64.2,0,0.0
FORD,S-MAX,2008,630,236,37.5,394,62.5,0,0.0
FORD,S-MAX,2009,161,72,44.7,89,55.3,0,0.0
FORD,S-MAX,2010,580,271,46.7,309,53.3,0,0.0
FORD,S-MAX,2011,150,71,47.3,79,52.7,0,0.0
FORD,S-MAX,2012,659,377,57.2,282,42.8,0,0.0
FORD,S-MAX,2013,95,60,63.2,35,36.8,0,0.0
FORD,S-MAX,2014,765,565,73.9,200,26.1,0,0.0
FORD,S-MAX,2015,37,27,73.0,10,27.0,0,0.0
FORD,S-MAX,2016,2,1,50.0,1,50.0,0,0.0
FORD,S-MAX 2.0 TDCI TITANIUM,2007,1,0,0.0,1,100.0,0,0.0
FORD,STREETKA,2003,4,0,0.0,4,100.0,0,0.0
FORD,STREETKA,2004,14,7,50.0,7,50.0,0,0.0
FORD,STREETKA,2005,6,3,50.0,3,50.0,0,0.0
FORD,STREETKA,2006,5,2,40.0,3,60.0,0,0.0
FORD,TOURNEO,2005,1,0,0.0,1,100.0,0,0.0
FORD,TOURNEO,2006,10,4,40.0,6,60.0,0,0.0
FORD,TOURNEO,2007,126,26,20.6,100,79.4,0,0.0
FORD,TOURNEO,2008,86,21,24.4,65,75.6,0,0.0
FORD,TOURNEO,2009,22,10,45.5,12,54.5,0,0.0
FORD,TOURNEO,2010,25,13,52.0,12,48.0,0,0.0
FORD,TOURNEO,2011,17,8,47.1,9,52.9,0,0.0
FORD,TOURNEO,2012,22,11,50.0,11,50.0,0,0.0
FORD,TOURNEO,2013,21,10,47.6,11,52.4,0,0.0
FORD,TOURNEO,2014,88,44,50.0,44,50.0,0,0.0
FORD,TOURNEO,2015,71,42,59.2,29,40.8,2,2.8
FORD,TOURNEO,2016,41,31,75.6,10,24.4,3,7.3
FORD,TOURNEO,2017,39,21,53.8,18,46.2,9,23.1
FORD,TOURNEO,2018,2,1,50.0,1,50.0,0,0.0
FORD,TOURNEO CONNECT,2004,2,0,0.0,2,100.0,0,0.0
FORD,TOURNEO CONNECT,2008,1,0,0.0,1,100.0,0,0.0
FORD,TOURNEO CONNECT,2015,1,1,100.0,0,0.0,0,0.0
FORD,TOURNEO CONNECT,2016,6,3,50.0,3,50.0,0,0.0
FORD,TOURNEO CONNECT,2017,3,2,66.7,1,33.3,1,33.3
FORD,TOURNEO CONNECT,2018,2,1,50.0,1,50.0,1,50.0
FORD,TRANSIT,2002,1,1,100.0,0,0.0,0,0.0
FORD,TRANSIT,2003,5,1,20.0,4,80.0,0,0.0
FORD,TRANSIT,2004,4,2,50.0,2,50.0,0,0.0
FORD,TRANSIT,2005,1,0,0.0,1,100.0,0,0.0
FORD,TRANSIT,2006,45,9,20.0,36,80.0,0,0.0
FORD,TRANSIT,2007,28,4,14.3,24,85.7,0,0.0
FORD,TRANSIT,2008,16,5,31.3,11,68.8,0,0.0
FORD,TRANSIT,2009,5,2,40.0,3,60.0,0,0.0
FORD,TRANSIT,2010,4,1,25.0,3,75.0,0,0.0
FORD,TRANSIT,2011,4,1,25.0,3,75.0,0,0.0
FORD,TRANSIT,2012,8,3,37.5,5,62.5,0,0.0
FORD,TRANSIT,2013,35,23,65.7,12,34.3,0,0.0
FORD,TRANSIT,2014,115,67,58.3,48,41.7,1,0.9
FORD,TRANSIT,2015,34,19,55.9,15,44.1,1,2.9
FORD,TRANSIT,2016,41,29,70.7,12,29.3,1,2.4
FORD,TRANSIT,2017,98,67,68.4,31,31.6,2,2.0
FORD,TRANSIT,2018,11,10,90.9,1,9.1,0,0.0
FORD,TRANSIT 2.2TDCI 290 CUSTOM ECO,2016,1,1,100.0,0,0.0,0,0.0
FORD,TRANSIT 330 LWB TD 5DR,2014,2,2,100.0,0,0.0,0,0.0
FORD,TRANSIT U 13 SEATS 260 SWB,2008,1,1,100.0,0,0.0,0,0.0
FQHL,VAUXHALL,2010,1,1,100.0,0,0.0,0,0.0
FSO,OTHER,1982,1,0,0.0,1,100.0,0,0.0
FSO,OTHER,1984,1,0,0.0,1,100.0,0,0.0
GMC,OTHER,1995,2,1,50.0,1,50.0,0,0.0
GOWRINGS,OTHER,2006,1,0,0.0,1,100.0,0,0.0
HOLDEN,OTHER,2002,1,0,0.0,1,100.0,0,0.0
HOLDEN,OTHER,2005,1,0,0.0,1,100.0,0,0.0
HOLDEN,OTHER,2006,2,1,50.0,1,50.0,0,0.0
HOLDEN,OTHER,2007,4,1,25.0,3,75.0,0,0.0
HOLDEN,OTHER,2011,1,0,0.0,1,100.0,0,0.0
HOLDEN,OTHER,2015,1,0,0.0,1,100.0,0,0.0
HONDA,ACCORD,1987,1,0,0.0,1,100.0,0,0.0
HONDA,ACCORD,1990,2,2,100.0,0,0.0,0,0.0
HONDA,ACCORD,1991,3,1,33.3,2,66.7,0,0.0
HONDA,ACCORD,1992,1,1,100.0,0,0.0,0,0.0
HONDA,ACCORD,1993,2,1,50.0,1,50.0,0,0.0
HONDA,ACCORD,1994,2,1,50.0,1,50.0,0,0.0
HONDA,ACCORD,1995,4,3,75.0,1,25.0,0,0.0
HONDA,ACCORD,1996,8,1,12.5,7,87.5,0,0.0
HONDA,ACCORD,1997,6,3,50.0,3,50.0,0,0.0
HONDA,ACCORD,1998,22,4,18.2,18,81.8,0,0.0
HONDA,ACCORD,1999,55,14,25.5,41,74.5,0,0.0
HONDA,ACCORD,2000,63,24,38.1,39,61.9,0,0.0
HONDA,ACCORD,2001,82,17,20.7,65,79.3,0,0.0
HONDA,ACCORD,2002,105,39,37.1,66,62.9,0,0.0
HONDA,ACCORD,2003,330,140,42.4,190,57.6,0,0.0
HONDA,ACCORD,2004,667,255,38.2,412,61.8,2,0.3
HONDA,ACCORD,2005,878,374,42.6,504,57.4,0,0.0
HONDA,ACCORD,2006,793,366,46.2,427,53.8,1,0.1
HONDA,ACCORD,2007,574,281,49.0,293,51.0,0,0.0
HONDA,ACCORD,2008,905,384,42.4,521,57.6,0,0.0
HONDA,ACCORD,2009,352,150,42.6,202,57.4,0,0.0
HONDA,ACCORD,2010,349,200,57.3,149,42.7,0,0.0
HONDA,ACCORD,2011,91,49,53.8,42,46.2,0,0.0
HONDA,ACCORD,2012,272,206,75.7,66,24.3,0,0.0
HONDA,ACCORD,2013,33,23,69.7,10,30.3,0,0.0
HONDA,ACCORD,2014,106,86,81.1,20,18.9,0,0.0
HONDA,ACCORD,2015,9,7,77.8,2,22.2,0,0.0
HONDA,ACCORD,2016,1,1,100.0,0,0.0,0,0.0
HONDA,ACCORD 2.0 ES 2DR,1998,1,0,0.0,1,100.0,0,0.0
HONDA,AIRWAVE,2006,1,1,100.0,0,0.0,0,0.0
HONDA,AIRWAVE,2007,2,1,50.0,1,50.0,0,0.0
HONDA,AIRWAVE,2008,1,0,0.0,1,100.0,0,0.0
HONDA,AIRWAVE,2010,1,0,0.0,1,100.0,0,0.0
HONDA,CIVIC,1980,1,1,100.0,0,0.0,0,0.0
HONDA,CIVIC,1983,1,1,100.0,0,0.0,0,0.0
HONDA,CIVIC,1984,1,1,100.0,0,0.0,0,0.0
HONDA,CIVIC,1985,1,1,100.0,0,0.0,0,0.0
HONDA,CIVIC,1987,1,1,100.0,0,0.0,0,0.0
HONDA,CIVIC,1988,2,0,0.0,2,100.0,0,0.0
HONDA,CIVIC,1989,6,4,66.7,2,33.3,0,0.0
HONDA,CIVIC,1990,27,11,40.7,16,59.3,0,0.0
HONDA,CIVIC,1991,29,10,34.5,19,65.5,0,0.0
HONDA,CIVIC,1992,34,13,38.2,21,61.8,0,0.0
HONDA,CIVIC,1993,34,9,26.5,25,73.5,0,0.0
HONDA,CIVIC,1994,41,8,19.5,33,80.5,0,0.0
HONDA,CIVIC,1995,59,16,27.1,43,72.9,1,1.7
HONDA,CIVIC,1996,143,43,30.1,100,69.9,0,0.0
HONDA,CIVIC,1997,219,61,27.9,158,72.1,0,0.0
HONDA,CIVIC,1998,312,75,24.0,237,76.0,0,0.0
HONDA,CIVIC,1999,461,112,24.3,349,75.7,0,0.0
HONDA,CIVIC,2000,558,137,24.6,421,75.4,0,0.0
HONDA,CIVIC,2001,708,284,40.1,424,59.9,0,0.0
HONDA,CIVIC,2002,1060,390,36.8,670,63.2,0,0.0
HONDA,CIVIC,2003,1131,435,38.5,696,61.5,0,0.0
HONDA,CIVIC,2004,1380,582,42.2,798,57.8,0,0.0
HONDA,CIVIC,2005,1406,664,47.2,742,52.8,0,0.0
HONDA,CIVIC,2006,1613,824,51.1,789,48.9,0,0.0
HONDA,CIVIC,2007,2063,1157,56.1,906,43.9,1,0.0
HONDA,CIVIC,2008,1558,828,53.1,730,46.9,6,0.4
HONDA,CIVIC,2009,497,283,56.9,214,43.1,1,0.2
HONDA,CIVIC,2010,727,469,64.5,258,35.5,3,0.4
HONDA,CIVIC,2011,99,65,65.7,34,34.3,0,0.0
HONDA,CIVIC,2012,624,525,84.1,99,15.9,0,0.0
HONDA,CIVIC,2013,201,160,79.6,41,20.4,0,0.0
HONDA,CIVIC,2014,827,696,84.2,131,15.8,0,0.0
HONDA,CIVIC,2015,83,68,81.9,15,18.1,0,0.0
HONDA,CIVIC,2016,6,4,66.7,2,33.3,0,0.0
HONDA,CIVIC 1.6I VTI JORDAN LT/ED 3D,1999,1,1,100.0,0,0.0,0,0.0
HONDA,CIVIC ES3 4DR,2006,1,0,0.0,1,100.0,0,0.0
HONDA,CROSSROAD,2008,3,2,66.7,1,33.3,0,0.0
HONDA,CRV SE EXECUTIVE 5DR A,2006,1,0,0.0,1,100.0,0,0.0
HONDA,CR-V SERIES,1996,1,0,0.0,1,100.0,0,0.0
HONDA,CR-V SERIES,1997,7,1,14.3,6,85.7,0,0.0
HONDA,CR-V SERIES,1998,72,21,29.2,51,70.8,0,0.0
HONDA,CR-V SERIES,1999,67,25,37.3,42,62.7,0,0.0
HONDA,CR-V SERIES,2000,111,33,29.7,78,70.3,0,0.0
HONDA,CR-V SERIES,2001,128,43,33.6,85,66.4,1,0.8
HONDA,CR-V SERIES,2002,248,129,52.0,119,48.0,0,0.0
HONDA,CR-V SERIES,2003,302,136,45.0,166,55.0,0,0.0
HONDA,CR-V SERIES,2004,309,165,53.4,144,46.6,2,0.6
HONDA,CR-V SERIES,2005,360,189,52.5,171,47.5,0,0.0
HONDA,CR-V SERIES,2006,337,189,56.1,148,43.9,0,0.0
HONDA,CR-V SERIES,2007,630,321,51.0,309,49.0,2,0.3
HONDA,CR-V SERIES,2008,222,142,64.0,80,36.0,2,0.9
HONDA,CR-V SERIES,2009,33,23,69.7,10,30.3,0,0.0
HONDA,CR-V SERIES,2010,60,40,66.7,20,33.3,0,0.0
HONDA,CR-V SERIES,2011,20,13,65.0,7,35.0,0,0.0
HONDA,CR-V SERIES,2012,81,62,76.5,19,23.5,0,0.0
HONDA,CR-V SERIES,2013,41,28,68.3,13,31.7,0,0.0
HONDA,CR-V SERIES,2014,502,391,77.9,111,22.1,1,0.2
HONDA,CR-V SERIES,2015,56,45,80.4,11,19.6,0,0.0
HONDA,CR-V SERIES,2016,2,2,100.0,0,0.0,0,0.0
HONDA,CRX,1989,1,0,0.0,1,100.0,0,0.0
HONDA,CRX,1990,1,1,100.0,0,0.0,0,0.0
HONDA,CRX,1992,2,0,0.0,2,100.0,0,0.0
HONDA,CRZ,2010,24,19,79.2,5,20.8,1,4.2
HONDA,CRZ,2011,17,7,41.2,10,58.8,0,0.0
HONDA,CRZ,2012,12,11,91.7,1,8.3,0,0.0
HONDA,CRZ,2014,6,6,100.0,0,0.0,0,0.0
HONDA,CRZ,2016,1,0,0.0,1,100.0,0,0.0
HONDA,EDIX,2004,1,0,0.0,1,100.0,0,0.0
HONDA,EDIX,2005,11,9,81.8,2,18.2,0,0.0
HONDA,EDIX,2006,14,6,42.9,8,57.1,0,0.0
HONDA,EDIX,2007,1,0,0.0,1,100.0,0,0.0
HONDA,ELYSION,2004,1,0,0.0,1,100.0,0,0.0
HONDA,ELYSION,2005,1,1,100.0,0,0.0,0,0.0
HONDA,FIT,2002,5,3,60.0,2,40.0,0,0.0
HONDA,FIT,2003,23,12,52.2,11,47.8,0,0.0
HONDA,FIT,2004,40,19,47.5,21,52.5,0,0.0
HONDA,FIT,2005,70,34,48.6,36,51.4,0,0.0
HONDA,FIT,2006,120,71,59.2,49,40.8,0,0.0
HONDA,FIT,2007,127,65,51.2,62,48.8,0,0.0
HONDA,FIT,2008,102,65,63.7,37,36.3,0,0.0
HONDA,FIT,2009,113,69,61.1,44,38.9,0,0.0
HONDA,FIT,2010,106,64,60.4,42,39.6,1,0.9
HONDA,FIT,2011,173,103,59.5,70,40.5,1,0.6
HONDA,FIT,2012,90,51,56.7,39,43.3,3,3.3
HONDA,FIT,2013,111,73,65.8,38,34.2,0,0.0
HONDA,FIT,2014,7,2,28.6,5,71.4,0,0.0
HONDA,FIT,2015,2,2,100.0,0,0.0,0,0.0
HONDA,FIT,2016,3,2,66.7,1,33.3,0,0.0
HONDA,FIT SHUTTLE,2012,5,4,80.0,1,20.0,0,0.0
HONDA,FIT SHUTTLE,2013,2,2,100.0,0,0.0,0,0.0
HONDA,FREED,2008,13,7,53.8,6,46.2,0,0.0
HONDA,FREED,2009,18,10,55.6,8,44.4,0,0.0
HONDA,FREED,2010,12,8,66.7,4,33.3,0,0.0
HONDA,FREED,2011,3,1,33.3,2,66.7,0,0.0
HONDA,FREED,2012,6,6,100.0,0,0.0,0,0.0
HONDA,FREED,2013,1,0,0.0,1,100.0,0,0.0
HONDA,FREED,2016,2,2,100.0,0,0.0,0,0.0
HONDA,FR-V,2004,7,2,28.6,5,71.4,0,0.0
HONDA,FR-V,2005,170,73,42.9,97,57.1,0,0.0
HONDA,FR-V,2006,185,90,48.6,95,51.4,0,0.0
HONDA,FR-V,2007,98,52,53.1,46,46.9,0,0.0
HONDA,FR-V,2008,101,47,46.5,54,53.5,0,0.0
HONDA,FR-V,2009,21,11,52.4,10,47.6,0,0.0
HONDA,FR-V,2010,15,11,73.3,4,26.7,0,0.0
HONDA,FR-V,2014,1,1,100.0,0,0.0,0,0.0
HONDA,HR-V,1999,33,10,30.3,23,69.7,0,0.0
HONDA,HR-V,2000,75,23,30.7,52,69.3,0,0.0
HONDA,HR-V,2001,60,28,46.7,32,53.3,0,0.0
HONDA,HR-V,2002,59,26,44.1,33,55.9,0,0.0
HONDA,HR-V,2003,116,48,41.4,68,58.6,1,0.9
HONDA,HR-V,2004,138,65,47.1,73,52.9,4,2.9
HONDA,HR-V,2005,85,54,63.5,31,36.5,0,0.0
HONDA,HR-V,2006,43,18,41.9,25,58.1,0,0.0
HONDA,HR-V,2015,1,1,100.0,0,0.0,0,0.0
HONDA,INSIGHT,2000,2,1,50.0,1,50.0,0,0.0
HONDA,INSIGHT,2006,1,0,0.0,1,100.0,0,0.0
HONDA,INSIGHT,2009,448,272,60.7,176,39.3,6,1.3
HONDA,INSIGHT,2010,326,213,65.3,113,34.7,6,1.8
HONDA,INSIGHT,2011,94,63,67.0,31,33.0,1,1.1
HONDA,INSIGHT,2012,151,111,73.5,40,26.5,4,2.6
HONDA,INSIGHT,2013,49,32,65.3,17,34.7,0,0.0
HONDA,INSIGHT,2014,27,22,81.5,5,18.5,1,3.7
HONDA,INSIGHT,2016,9,5,55.6,4,44.4,0,0.0
HONDA,INTEGRA,1987,1,1,100.0,0,0.0,0,0.0
HONDA,INTEGRA,1989,1,1,100.0,0,0.0,0,0.0
HONDA,INTEGRA,1991,6,1,16.7,5,83.3,0,0.0
HONDA,INTEGRA,1992,3,0,0.0,3,100.0,0,0.0
HONDA,INTEGRA,1993,1,0,0.0,1,100.0,0,0.0
HONDA,INTEGRA,1994,2,1,50.0,1,50.0,0,0.0
HONDA,INTEGRA,1995,3,1,33.3,2,66.7,0,0.0
HONDA,INTEGRA,1996,25,5,20.0,20,80.0,0,0.0
HONDA,INTEGRA,1997,33,9,27.3,24,72.7,0,0.0
HONDA,INTEGRA,1998,52,13,25.0,39,75.0,0,0.0
HONDA,INTEGRA,1999,23,8,34.8,15,65.2,0,0.0
HONDA,INTEGRA,2000,21,5,23.8,16,76.2,0,0.0
HONDA,INTEGRA,2001,55,12,21.8,43,78.2,0,0.0
HONDA,INTEGRA,2002,53,22,41.5,31,58.5,0,0.0
HONDA,INTEGRA,2003,23,8,34.8,15,65.2,0,0.0
HONDA,INTEGRA,2004,17,7,41.2,10,58.8,0,0.0
HONDA,INTEGRA,2005,8,4,50.0,4,50.0,0,0.0
HONDA,INTEGRA,2006,5,1,20.0,4,80.0,0,0.0
HONDA,INTEGRA,2007,1,0,0.0,1,100.0,0,0.0
HONDA,INTEGRA DC 2 SIR 2DR,1997,1,0,0.0,1,100.0,0,0.0
HONDA,JAZZ,1985,1,1,100.0,0,0.0,0,0.0
HONDA,JAZZ,1988,1,0,0.0,1,100.0,0,0.0
HONDA,JAZZ,1990,2,1,50.0,1,50.0,0,0.0
HONDA,JAZZ,2002,221,99,44.8,122,55.2,0,0.0
HONDA,JAZZ,2003,214,106,49.5,108,50.5,0,0.0
HONDA,JAZZ,2004,256,132,51.6,124,48.4,0,0.0
HONDA,JAZZ,2005,587,304,51.8,283,48.2,0,0.0
HONDA,JAZZ,2006,604,348,57.6,256,42.4,0,0.0
HONDA,JAZZ,2007,409,252,61.6,157,38.4,1,0.2
HONDA,JAZZ,2008,282,171,60.6,111,39.4,0,0.0
HONDA,JAZZ,2009,198,129,65.2,69,34.8,0,0.0
HONDA,JAZZ,2010,247,199,80.6,48,19.4,0,0.0
HONDA,JAZZ,2011,58,39,67.2,19,32.8,0,0.0
HONDA,JAZZ,2012,201,167,83.1,34,16.9,0,0.0
HONDA,JAZZ,2013,48,37,77.1,11,22.9,0,0.0
HONDA,JAZZ,2014,251,231,92.0,20,8.0,0,0.0
HONDA,JAZZ,2015,24,19,79.2,5,20.8,0,0.0
HONDA,JAZZ,2016,1,1,100.0,0,0.0,0,0.0
HONDA,LEGEND,1988,1,1,100.0,0,0.0,0,0.0
HONDA,LEGEND,1993,1,1,100.0,0,0.0,0,0.0
HONDA,LEGEND,1996,1,0,0.0,1,100.0,0,0.0
HONDA,LEGEND,2000,1,0,0.0,1,100.0,0,0.0
HONDA,LEGEND,2001,2,1,50.0,1,50.0,0,0.0
HONDA,LEGEND,2003,1,1,100.0,0,0.0,0,0.0
HONDA,LEGEND,2006,2,1,50.0,1,50.0,0,0.0
HONDA,LEGEND,2007,5,3,60.0,2,40.0,0,0.0
HONDA,LEGEND,2008,1,0,0.0,1,100.0,0,0.0
HONDA,LEGEND,2009,2,1,50.0,1,50.0,0,0.0
HONDA,MOBILIO,2002,1,0,0.0,1,100.0,0,0.0
HONDA,MOBILIO,2003,1,0,0.0,1,100.0,0,0.0
HONDA,MOBILIO,2005,5,2,40.0,3,60.0,0,0.0
HONDA,MOBILIO,2006,5,4,80.0,1,20.0,0,0.0
HONDA,MOBILIO,2007,8,4,50.0,4,50.0,0,0.0
HONDA,ODYSSEY,2004,3,2,66.7,1,33.3,0,0.0
HONDA,ODYSSEY,2011,1,1,100.0,0,0.0,0,0.0
HONDA,ODYSSEY,2014,1,1,100.0,0,0.0,0,0.0
HONDA,OTHER,1985,1,1,100.0,0,0.0,0,0.0
HONDA,OTHER,1990,4,0,0.0,4,100.0,0,0.0
HONDA,OTHER,1991,18,9,50.0,9,50.0,0,0.0
HONDA,OTHER,1992,12,4,33.3,8,66.7,0,0.0
HONDA,OTHER,1993,5,0,0.0,5,100.0,0,0.0
HONDA,OTHER,1994,2,2,100.0,0,0.0,0,0.0
HONDA,OTHER,1995,5,1,20.0,4,80.0,0,0.0
HONDA,OTHER,1996,5,1,20.0,4,80.0,0,0.0
HONDA,OTHER,1997,6,2,33.3,4,66.7,0,0.0
HONDA,OTHER,1998,36,12,33.3,24,66.7,0,0.0
HONDA,OTHER,1999,43,16,37.2,27,62.8,0,0.0
HONDA,OTHER,2000,40,19,47.5,21,52.5,0,0.0
HONDA,OTHER,2001,25,9,36.0,16,64.0,0,0.0
HONDA,OTHER,2002,37,16,43.2,21,56.8,0,0.0
HONDA,OTHER,2003,57,31,54.4,26,45.6,0,0.0
HONDA,OTHER,2004,41,25,61.0,16,39.0,0,0.0
HONDA,OTHER,2005,36,20,55.6,16,44.4,0,0.0
HONDA,OTHER,2006,20,10,50.0,10,50.0,0,0.0
HONDA,OTHER,2007,9,2,22.2,7,77.8,0,0.0
HONDA,OTHER,2010,2,2,100.0,0,0.0,0,0.0
HONDA,OTHER,2014,1,1,100.0,0,0.0,0,0.0
HONDA,PRELUDE,1983,1,1,100.0,0,0.0,0,0.0
HONDA,PRELUDE,1984,1,1,100.0,0,0.0,0,0.0
HONDA,PRELUDE,1985,1,0,0.0,1,100.0,0,0.0
HONDA,PRELUDE,1988,1,1,100.0,0,0.0,0,0.0
HONDA,PRELUDE,1990,2,2,100.0,0,0.0,0,0.0
HONDA,PRELUDE,1991,3,1,33.3,2,66.7,0,0.0
HONDA,PRELUDE,1992,5,0,0.0,5,100.0,0,0.0
HONDA,PRELUDE,1993,7,4,57.1,3,42.9,0,0.0
HONDA,PRELUDE,1994,5,2,40.0,3,60.0,0,0.0
HONDA,PRELUDE,1996,6,3,50.0,3,50.0,0,0.0
HONDA,PRELUDE,1997,12,1,8.3,11,91.7,0,0.0
HONDA,PRELUDE,1998,12,3,25.0,9,75.0,0,0.0
HONDA,PRELUDE,1999,7,5,71.4,2,28.6,0,0.0
HONDA,PRELUDE,2000,4,3,75.0,1,25.0,0,0.0
HONDA,PRELUDE,2001,1,0,0.0,1,100.0,0,0.0
HONDA,S2000,1999,23,12,52.2,11,47.8,0,0.0
HONDA,S2000,2000,20,9,45.0,11,55.0,1,5.0
HONDA,S2000,2001,8,3,37.5,5,62.5,0,0.0
HONDA,S2000,2002,15,9,60.0,6,40.0,0,0.0
HONDA,S2000,2003,9,6,66.7,3,33.3,0,0.0
HONDA,S2000,2004,13,13,100.0,0,0.0,0,0.0
HONDA,S2000,2005,4,4,100.0,0,0.0,0,0.0
HONDA,S2000,2006,7,6,85.7,1,14.3,0,0.0
HONDA,S2000,2007,2,2,100.0,0,0.0,0,0.0
HONDA,S2000,2008,2,2,100.0,0,0.0,0,0.0
HONDA,SHUTTLE,1999,1,1,100.0,0,0.0,0,0.0
HONDA,SMX,1997,1,0,0.0,1,100.0,0,0.0
HONDA,STEPWAGON,1999,1,0,0.0,1,100.0,0,0.0
HONDA,STEPWAGON,2001,2,1,50.0,1,50.0,0,0.0
HONDA,STEPWAGON,2002,4,2,50.0,2,50.0,0,0.0
HONDA,STEPWAGON,2004,2,0,0.0,2,100.0,0,0.0
HONDA,STEPWAGON,2005,18,8,44.4,10,55.6,0,0.0
HONDA,STEPWAGON,2006,51,31,60.8,20,39.2,0,0.0
HONDA,STEPWAGON,2007,36,20,55.6,16,44.4,0,0.0
HONDA,STEPWAGON,2008,15,5,33.3,10,66.7,0,0.0
HONDA,STEPWAGON,2009,7,3,42.9,4,57.1,0,0.0
HONDA,STEPWAGON,2010,3,3,100.0,0,0.0,0,0.0
HONDA,STEPWAGON,2011,1,0,0.0,1,100.0,0,0.0
HONDA,STREAM,2000,7,1,14.3,6,85.7,0,0.0
HONDA,STREAM,2001,60,24,40.0,36,60.0,0,0.0
HONDA,STREAM,2002,98,31,31.6,67,68.4,0,0.0
HONDA,STREAM,2003,80,32,40.0,48,60.0,0,0.0
HONDA,STREAM,2004,78,24,30.8,54,69.2,0,0.0
HONDA,STREAM,2005,49,25,51.0,24,49.0,0,0.0
HONDA,STREAM,2006,133,63,47.4,70,52.6,0,0.0
HONDA,STREAM,2007,135,63,46.7,72,53.3,1,0.7
HONDA,STREAM,2008,89,45,50.6,44,49.4,0,0.0
HONDA,STREAM,2009,60,42,70.0,18,30.0,0,0.0
HONDA,STREAM,2010,14,10,71.4,4,28.6,0,0.0
HONDA,STREAM,2011,3,1,33.3,2,66.7,0,0.0
HONDA,STREAM,2016,12,9,75.0,3,25.0,0,0.0
HONDA,STREAM 1.7 MPV 5DR,2002,1,1,100.0,0,0.0,0,0.0
HUMMER,H2,2008,2,1,50.0,1,50.0,0,0.0
HUMMER,OTHER,2006,1,0,0.0,1,100.0,0,0.0
HUMMER,OTHER,2007,5,2,40.0,3,60.0,0,0.0
HUMMER,OTHER,2008,2,1,50.0,1,50.0,1,50.0
HYUNDAI,ACCENT,1995,1,1,100.0,0,0.0,0,0.0
HYUNDAI,ACCENT,1996,5,3,60.0,2,40.0,0,0.0
HYUNDAI,ACCENT,1997,21,8,38.1,13,61.9,0,0.0
HYUNDAI,ACCENT,1998,48,11,22.9,37,77.1,0,0.0
HYUNDAI,ACCENT,1999,64,20,31.3,44,68.8,0,0.0
HYUNDAI,ACCENT,2000,226,59,26.1,167,73.9,0,0.0
HYUNDAI,ACCENT,2001,156,35,22.4,121,77.6,0,0.0
HYUNDAI,ACCENT,2002,175,45,25.7,130,74.3,0,0.0
HYUNDAI,ACCENT,2003,288,101,35.1,187,64.9,0,0.0
HYUNDAI,ACCENT,2004,576,162,28.1,414,71.9,0,0.0
HYUNDAI,ACCENT,2005,641,265,41.3,376,58.7,0,0.0
HYUNDAI,ACCENT,2006,580,264,45.5,316,54.5,0,0.0
HYUNDAI,ACCENT,2007,737,362,49.1,375,50.9,0,0.0
HYUNDAI,ACCENT,2008,225,107,47.6,118,52.4,0,0.0
HYUNDAI,ACCENT,2009,53,26,49.1,27,50.9,0,0.0
HYUNDAI,AMICA,2000,3,1,33.3,2,66.7,0,0.0
HYUNDAI,AMICA,2001,2,0,0.0,2,100.0,0,0.0
HYUNDAI,AMICA,2002,5,2,40.0,3,60.0,0,0.0
HYUNDAI,AMICA,2006,12,8,66.7,4,33.3,0,0.0
HYUNDAI,AMICA,2007,16,6,37.5,10,62.5,0,0.0
HYUNDAI,AMICA,2008,5,1,20.0,4,80.0,0,0.0
HYUNDAI,ATOZ,1998,8,3,37.5,5,62.5,0,0.0
HYUNDAI,ATOZ,1999,34,7,20.6,27,79.4,0,0.0
HYUNDAI,ATOZ,2000,126,35,27.8,91,72.2,0,0.0
HYUNDAI,ATOZ,2001,54,17,31.5,37,68.5,0,0.0
HYUNDAI,ATOZ,2002,34,9,26.5,25,73.5,0,0.0
HYUNDAI,ATOZ,2003,3,1,33.3,2,66.7,0,0.0
HYUNDAI,ATOZ,2006,197,90,45.7,107,54.3,0,0.0
HYUNDAI,ATOZ,2007,139,64,46.0,75,54.0,0,0.0
HYUNDAI,ATOZ,2009,1,0,0.0,1,100.0,0,0.0
HYUNDAI,COUPE,2006,10,6,60.0,4,40.0,0,0.0
HYUNDAI,COUPE,2007,368,172,46.7,196,53.3,0,0.0
HYUNDAI,COUPE,2008,139,70,50.4,69,49.6,0,0.0
HYUNDAI,COUPE,2009,29,16,55.2,13,44.8,0,0.0
HYUNDAI,COUPE,2010,5,2,40.0,3,60.0,0,0.0
HYUNDAI,COUPE FX,2004,3,1,33.3,2,66.7,0,0.0
HYUNDAI,COUPE FX,2005,11,1,9.1,10,90.9,0,0.0
HYUNDAI,ELANTRA,2002,2,0,0.0,2,100.0,0,0.0
HYUNDAI,ELANTRA,2003,3,2,66.7,1,33.3,0,0.0
HYUNDAI,ELANTRA,2004,35,9,25.7,26,74.3,0,0.0
HYUNDAI,ELANTRA,2005,54,19,35.2,35,64.8,0,0.0
HYUNDAI,ELANTRA,2006,51,17,33.3,34,66.7,0,0.0
HYUNDAI,ELANTRA,2007,106,39,36.8,67,63.2,0,0.0
HYUNDAI,ELANTRA,2008,1,0,0.0,1,100.0,0,0.0
HYUNDAI,ELANTRA,2009,1,1,100.0,0,0.0,0,0.0
HYUNDAI,ELANTRA,2011,1,1,100.0,0,0.0,0,0.0
HYUNDAI,ELANTRA,2012,2,2,100.0,0,0.0,0,0.0
HYUNDAI,ELANTRA,2013,1,0,0.0,1,100.0,0,0.0
HYUNDAI,GETZ,2002,12,3,25.0,9,75.0,0,0.0
HYUNDAI,GETZ,2003,116,31,26.7,85,73.3,0,0.0
HYUNDAI,GETZ,2004,326,111,34.0,215,66.0,0,0.0
HYUNDAI,GETZ,2005,583,217,37.2,366,62.8,0,0.0
HYUNDAI,GETZ,2006,561,252,44.9,309,55.1,0,0.0
HYUNDAI,GETZ,2007,459,224,48.8,235,51.2,0,0.0
HYUNDAI,GETZ,2008,163,72,44.2,91,55.8,0,0.0
HYUNDAI,GETZ,2009,48,26,54.2,22,45.8,0,0.0
HYUNDAI,GETZ 1.1 GSI 3DR,2006,1,1,100.0,0,0.0,0,0.0
HYUNDAI,GRANDEUR,2006,4,1,25.0,3,75.0,0,0.0
HYUNDAI,GRANDEUR,2009,1,0,0.0,1,100.0,0,0.0
HYUNDAI,I10,2008,195,105,53.8,90,46.2,0,0.0
HYUNDAI,I10,2009,102,61,59.8,41,40.2,0,0.0
HYUNDAI,I10,2010,207,142,68.6,65,31.4,0,0.0
HYUNDAI,I10,2011,91,59,64.8,32,35.2,0,0.0
HYUNDAI,I10,2012,298,209,70.1,89,29.9,0,0.0
HYUNDAI,I10,2013,85,61,71.8,24,28.2,0,0.0
HYUNDAI,I10,2014,774,623,80.5,151,19.5,0,0.0
HYUNDAI,I10,2015,97,86,88.7,11,11.3,0,0.0
HYUNDAI,I10,2016,2,0,0.0,2,100.0,0,0.0
HYUNDAI,I20,2008,2,1,50.0,1,50.0,0,0.0
HYUNDAI,I20,2009,224,130,58.0,94,42.0,0,0.0
HYUNDAI,I20,2010,690,455,65.9,235,34.1,0,0.0
HYUNDAI,I20,2011,213,140,65.7,73,34.3,0,0.0
HYUNDAI,I20,2012,381,278,73.0,103,27.0,0,0.0
HYUNDAI,I20,2013,204,146,71.6,58,28.4,1,0.5
HYUNDAI,I20,2014,646,522,80.8,124,19.2,0,0.0
HYUNDAI,I20,2015,117,105,89.7,12,10.3,0,0.0
HYUNDAI,I20,2016,2,2,100.0,0,0.0,0,0.0
HYUNDAI,I30,2007,40,15,37.5,25,62.5,0,0.0
HYUNDAI,I30,2008,789,388,49.2,401,50.8,0,0.0
HYUNDAI,I30,2009,395,185,46.8,210,53.2,1,0.3
HYUNDAI,I30,2010,1538,866,56.3,672,43.7,1,0.1
HYUNDAI,I30,2011,501,294,58.7,207,41.3,0,0.0
HYUNDAI,I30,2012,1706,1121,65.7,585,34.3,0,0.0
HYUNDAI,I30,2013,582,452,77.7,130,22.3,1,0.2
HYUNDAI,I30,2014,1925,1598,83.0,327,17.0,1,0.1
HYUNDAI,I30,2015,176,147,83.5,29,16.5,1,0.6
HYUNDAI,I30,2016,13,7,53.8,6,46.2,0,0.0
HYUNDAI,I40,2011,37,20,54.1,17,45.9,0,0.0
HYUNDAI,I40,2012,1903,1282,67.4,621,32.6,4,0.2
HYUNDAI,I40,2013,449,319,71.0,130,29.0,0,0.0
HYUNDAI,I40,2014,1720,1223,71.1,497,28.9,2,0.1
HYUNDAI,I40,2015,197,138,70.1,59,29.9,0,0.0
HYUNDAI,I40,2016,33,29,87.9,4,12.1,0,0.0
HYUNDAI,I40,2017,7,6,85.7,1,14.3,0,0.0
HYUNDAI,I40,2018,1,0,0.0,1,100.0,0,0.0
HYUNDAI,I45,2012,1,1,100.0,0,0.0,0,0.0
HYUNDAI,I800,2008,2,2,100.0,0,0.0,0,0.0
HYUNDAI,I800,2009,2,1,50.0,1,50.0,0,0.0
HYUNDAI,I800,2010,4,1,25.0,3,75.0,0,0.0
HYUNDAI,I800,2011,5,1,20.0,4,80.0,0,0.0
HYUNDAI,I800,2012,10,5,50.0,5,50.0,0,0.0
HYUNDAI,I800,2015,1,0,0.0,1,100.0,0,0.0
HYUNDAI,I800,2016,4,1,25.0,3,75.0,0,0.0
HYUNDAI,I800,2017,1,1,100.0,0,0.0,0,0.0
HYUNDAI,IX20,2010,4,1,25.0,3,75.0,0,0.0
HYUNDAI,IX20,2011,67,41,61.2,26,38.8,0,0.0
HYUNDAI,IX20,2012,487,351,72.1,136,27.9,0,0.0
HYUNDAI,IX20,2013,88,65,73.9,23,26.1,0,0.0
HYUNDAI,IX20,2014,385,296,76.9,89,23.1,1,0.3
HYUNDAI,IX20,2015,82,67,81.7,15,18.3,0,0.0
HYUNDAI,IX35,2010,490,318,64.9,172,35.1,1,0.2
HYUNDAI,IX35,2011,270,177,65.6,93,34.4,0,0.0
HYUNDAI,IX35,2012,1855,1314,70.8,541,29.2,0,0.0
HYUNDAI,IX35,2013,428,311,72.7,117,27.3,0,0.0
HYUNDAI,IX35,2014,2810,2253,80.2,557,19.8,0,0.0
HYUNDAI,IX35,2015,344,292,84.9,52,15.1,0,0.0
HYUNDAI,IX35,2016,1,1,100.0,0,0.0,0,0.0
HYUNDAI,LANTRA,1997,10,1,10.0,9,90.0,0,0.0
HYUNDAI,LANTRA,1998,12,2,16.7,10,83.3,0,0.0
HYUNDAI,LANTRA,1999,23,8,34.8,15,65.2,0,0.0
HYUNDAI,LANTRA,2000,33,10,30.3,23,69.7,0,0.0
HYUNDAI,LANTRA,2001,29,6,20.7,23,79.3,0,0.0
HYUNDAI,LANTRA,2002,84,15,17.9,69,82.1,0,0.0
HYUNDAI,LANTRA,2003,167,35,21.0,132,79.0,0,0.0
HYUNDAI,LANTRA,2004,264,75,28.4,189,71.6,1,0.4
HYUNDAI,LANTRA,2005,30,15,50.0,15,50.0,0,0.0
HYUNDAI,MATRIX,2001,1,0,0.0,1,100.0,0,0.0
HYUNDAI,MATRIX,2002,30,9,30.0,21,70.0,0,0.0
HYUNDAI,MATRIX,2003,53,16,30.2,37,69.8,0,0.0
HYUNDAI,MATRIX,2004,55,17,30.9,38,69.1,0,0.0
HYUNDAI,MATRIX,2005,95,24,25.3,71,74.7,0,0.0
HYUNDAI,MATRIX,2006,128,42,32.8,86,67.2,0,0.0
HYUNDAI,MATRIX,2007,77,26,33.8,51,66.2,0,0.0
HYUNDAI,MATRIX,2008,38,16,42.1,22,57.9,0,0.0
HYUNDAI,MATRIX,2009,16,11,68.8,5,31.3,0,0.0
HYUNDAI,MATRIX,2010,16,7,43.8,9,56.3,0,0.0
HYUNDAI,MONTANA,2008,61,15,24.6,46,75.4,0,0.0
HYUNDAI,MONTANA,2009,7,3,42.9,4,57.1,0,0.0
HYUNDAI,MONTANA,2010,29,13,44.8,16,55.2,0,0.0
HYUNDAI,MONTANA,2011,2,0,0.0,2,100.0,0,0.0
HYUNDAI,MONTANA,2012,10,6,60.0,4,40.0,0,0.0
HYUNDAI,MONTANA,2013,3,2,66.7,1,33.3,0,0.0
HYUNDAI,MONTANA,2014,14,5,35.7,9,64.3,1,7.1
HYUNDAI,MONTANA,2015,2,0,0.0,2,100.0,0,0.0
HYUNDAI,MONTANA,2016,1,1,100.0,0,0.0,0,0.0
HYUNDAI,OTHER,2000,2,0,0.0,2,100.0,0,0.0
HYUNDAI,OTHER,2001,29,5,17.2,24,82.8,0,0.0
HYUNDAI,OTHER,2002,83,24,28.9,59,71.1,0,0.0
HYUNDAI,OTHER,2003,496,129,26.0,367,74.0,0,0.0
HYUNDAI,OTHER,2004,452,125,27.7,327,72.3,0,0.0
HYUNDAI,OTHER,2005,585,196,33.5,389,66.5,1,0.2
HYUNDAI,OTHER,2006,459,189,41.2,270,58.8,0,0.0
HYUNDAI,OTHER,2007,91,38,41.8,53,58.2,0,0.0
HYUNDAI,OTHER,2008,60,29,48.3,31,51.7,0,0.0
HYUNDAI,OTHER,2009,96,52,54.2,44,45.8,0,0.0
HYUNDAI,OTHER,2010,445,265,59.6,180,40.4,0,0.0
HYUNDAI,OTHER,2011,3,2,66.7,1,33.3,0,0.0
HYUNDAI,OTHER,2012,4,3,75.0,1,25.0,0,0.0
HYUNDAI,OTHER,2014,2,1,50.0,1,50.0,0,0.0
HYUNDAI,PONY,1990,1,0,0.0,1,100.0,0,0.0
HYUNDAI,S COUPE,2000,4,1,25.0,3,75.0,0,0.0
HYUNDAI,S COUPE,2001,5,2,40.0,3,60.0,0,0.0
HYUNDAI,S COUPE,2002,17,7,41.2,10,58.8,0,0.0
HYUNDAI,S COUPE,2003,28,11,39.3,17,60.7,0,0.0
HYUNDAI,S COUPE,2004,18,5,27.8,13,72.2,0,0.0
HYUNDAI,S COUPE,2005,8,4,50.0,4,50.0,0,0.0
HYUNDAI,S COUPE,2006,6,2,33.3,4,66.7,0,0.0
HYUNDAI,SANTA FE,2001,20,4,20.0,16,80.0,0,0.0
HYUNDAI,SANTA FE,2002,139,29,20.9,110,79.1,0,0.0
HYUNDAI,SANTA FE,2003,311,79,25.4,232,74.6,0,0.0
HYUNDAI,SANTA FE,2004,614,169,27.5,445,72.5,1,0.2
HYUNDAI,SANTA FE,2005,1048,341,32.5,707,67.5,1,0.1
HYUNDAI,SANTA FE,2006,1310,398,30.4,912,69.6,0,0.0
HYUNDAI,SANTA FE,2007,1552,481,31.0,1071,69.0,3,0.2
HYUNDAI,SANTA FE,2008,642,216,33.6,426,66.4,0,0.0
HYUNDAI,SANTA FE,2009,82,25,30.5,57,69.5,0,0.0
HYUNDAI,SANTA FE,2010,221,99,44.8,122,55.2,0,0.0
HYUNDAI,SANTA FE,2011,64,31,48.4,33,51.6,0,0.0
HYUNDAI,SANTA FE,2012,254,127,50.0,127,50.0,0,0.0
HYUNDAI,SANTA FE,2013,87,49,56.3,38,43.7,0,0.0
HYUNDAI,SANTA FE,2014,584,453,77.6,131,22.4,4,0.7
HYUNDAI,SANTA FE,2015,93,78,83.9,15,16.1,0,0.0
HYUNDAI,SONATA,1998,1,0,0.0,1,100.0,0,0.0
HYUNDAI,SONATA,1999,3,0,0.0,3,100.0,0,0.0
HYUNDAI,SONATA,2000,5,4,80.0,1,20.0,0,0.0
HYUNDAI,SONATA,2001,1,0,0.0,1,100.0,0,0.0
HYUNDAI,SONATA,2002,9,2,22.2,7,77.8,0,0.0
HYUNDAI,SONATA,2003,21,7,33.3,14,66.7,0,0.0
HYUNDAI,SONATA,2004,36,7,19.4,29,80.6,0,0.0
HYUNDAI,SONATA,2005,29,12,41.4,17,58.6,0,0.0
HYUNDAI,SONATA,2006,147,60,40.8,87,59.2,0,0.0
HYUNDAI,SONATA,2007,219,99,45.2,120,54.8,0,0.0
HYUNDAI,SONATA,2008,81,30,37.0,51,63.0,0,0.0
HYUNDAI,SONATA,2009,33,16,48.5,17,51.5,0,0.0
HYUNDAI,SONATA,2010,54,26,48.1,28,51.9,0,0.0
HYUNDAI,SONATA,2011,3,2,66.7,1,33.3,0,0.0
HYUNDAI,TERRACAN,2003,4,1,25.0,3,75.0,0,0.0
HYUNDAI,TERRACAN,2004,1,0,0.0,1,100.0,0,0.0
HYUNDAI,TERRACAN,2005,5,1,20.0,4,80.0,0,0.0
HYUNDAI,TERRACAN,2006,2,1,50.0,1,50.0,0,0.0
HYUNDAI,TERRACAN,2007,1,0,0.0,1,100.0,0,0.0
HYUNDAI,TRAJET,2000,6,1,16.7,5,83.3,0,0.0
HYUNDAI,TRAJET,2001,18,6,33.3,12,66.7,0,0.0
HYUNDAI,TRAJET,2002,58,11,19.0,47,81.0,0,0.0
HYUNDAI,TRAJET,2003,85,7,8.2,78,91.8,0,0.0
HYUNDAI,TRAJET,2004,196,26,13.3,170,86.7,0,0.0
HYUNDAI,TRAJET,2005,354,78,22.0,276,78.0,0,0.0
HYUNDAI,TRAJET,2006,390,91,23.3,299,76.7,0,0.0
HYUNDAI,TRAJET,2007,275,56,20.4,219,79.6,0,0.0
HYUNDAI,TUCSON,2004,13,3,23.1,10,76.9,1,7.7
HYUNDAI,TUCSON,2005,813,231,28.4,582,71.6,1,0.1
HYUNDAI,TUCSON,2006,994,323,32.5,671,67.5,0,0.0
HYUNDAI,TUCSON,2007,858,272,31.7,586,68.3,0,0.0
HYUNDAI,TUCSON,2008,274,105,38.3,169,61.7,0,0.0
HYUNDAI,TUCSON,2009,34,16,47.1,18,52.9,0,0.0
HYUNDAI,TUCSON,2010,21,13,61.9,8,38.1,0,0.0
HYUNDAI,TUCSON,2015,2,0,0.0,2,100.0,0,0.0
HYUNDAI,TUCSON,2016,11,10,90.9,1,9.1,0,0.0
HYUNDAI,TUCSON,2017,3,3,100.0,0,0.0,0,0.0
HYUNDAI,TUCSON,2018,3,2,66.7,1,33.3,0,0.0
HYUNDAI,TUCSON 2.0 2WD 5DR,2008,1,0,0.0,1,100.0,0,0.0
HYUNDAI,TUCSON 2.0 CDX 4WD,2004,1,0,0.0,1,100.0,0,0.0
HYUNDAI,VELOSTER,2012,80,56,70.0,24,30.0,0,0.0
HYUNDAI,VELOSTER,2013,37,25,67.6,12,32.4,0,0.0
HYUNDAI,VELOSTER,2014,59,45,76.3,14,23.7,0,0.0
HYUNDAI,VELOSTER,2015,3,2,66.7,1,33.3,0,0.0
IMPERIAL,OTHER,1988,3,1,33.3,2,66.7,0,0.0
INFINITI,OTHER,2013,1,1,100.0,0,0.0,0,0.0
INFINITI,OTHER,2014,3,2,66.7,1,33.3,0,0.0
ISUZU,OTHER,1988,3,2,66.7,1,33.3,0,0.0
ISUZU,OTHER,1989,1,0,0.0,1,100.0,0,0.0
ISUZU,OTHER,1995,2,0,0.0,2,100.0,0,0.0
ISUZU,OTHER,1996,1,0,0.0,1,100.0,0,0.0
ISUZU,OTHER,1997,2,0,0.0,2,100.0,0,0.0
ISUZU,OTHER,1998,1,1,100.0,0,0.0,0,0.0
ISUZU,OTHER,1999,1,0,0.0,1,100.0,0,0.0
ISUZU,OTHER,2000,1,1,100.0,0,0.0,0,0.0
ISUZU,OTHER,2003,2,0,0.0,2,100.0,0,0.0
ISUZU,OTHER,2005,1,1,100.0,0,0.0,0,0.0
ISUZU,OTHER,2007,2,1,50.0,1,50.0,0,0.0
ISUZU,UBS,1998,2,0,0.0,2,100.0,0,0.0
ISUZU,UBS,1999,1,0,0.0,1,100.0,0,0.0
ISUZU,UBS,2000,3,0,0.0,3,100.0,0,0.0
ISUZU,UBS,2001,4,2,50.0,2,50.0,0,0.0
ISUZU,UBS,2002,8,1,12.5,7,87.5,0,0.0
ISUZU,UBS,2003,1,1,100.0,0,0.0,0,0.0
ISUZU,UBS,2004,6,2,33.3,4,66.7,0,0.0
ISUZU,UBS,2005,3,2,66.7,1,33.3,0,0.0
ISUZU,UBS,2006,1,0,0.0,1,100.0,0,0.0
ISUZU,UBS,2007,2,0,0.0,2,100.0,0,0.0
IVECO,OTHER,2007,1,0,0.0,1,100.0,0,0.0
JAGUAR,E TYPE,1969,2,1,50.0,1,50.0,0,0.0
JAGUAR,F-TYPE,2013,3,3,100.0,0,0.0,0,0.0
JAGUAR,F-TYPE,2014,1,0,0.0,1,100.0,0,0.0
JAGUAR,OTHER,1962,1,0,0.0,1,100.0,0,0.0
JAGUAR,OTHER,1968,2,0,0.0,2,100.0,0,0.0
JAGUAR,OTHER,1982,2,2,100.0,0,0.0,0,0.0
JAGUAR,OTHER,1983,3,3,100.0,0,0.0,0,0.0
JAGUAR,OTHER,1984,3,2,66.7,1,33.3,0,0.0
JAGUAR,OTHER,1985,3,1,33.3,2,66.7,0,0.0
JAGUAR,OTHER,1986,2,1,50.0,1,50.0,0,0.0
JAGUAR,OTHER,1987,2,1,50.0,1,50.0,0,0.0
JAGUAR,OTHER,1988,3,1,33.3,2,66.7,0,0.0
JAGUAR,OTHER,1990,3,1,33.3,2,66.7,0,0.0
JAGUAR,OTHER,1991,7,4,57.1,3,42.9,0,0.0
JAGUAR,OTHER,1992,2,0,0.0,2,100.0,0,0.0
JAGUAR,OTHER,1993,5,1,20.0,4,80.0,0,0.0
JAGUAR,OTHER,1994,7,3,42.9,4,57.1,0,0.0
JAGUAR,OTHER,1995,10,4,40.0,6,60.0,0,0.0
JAGUAR,OTHER,1996,13,4,30.8,9,69.2,0,0.0
JAGUAR,OTHER,1997,28,14,50.0,14,50.0,0,0.0
JAGUAR,OTHER,1998,36,17,47.2,19,52.8,0,0.0
JAGUAR,OTHER,1999,22,10,45.5,12,54.5,0,0.0
JAGUAR,OTHER,2000,39,16,41.0,23,59.0,0,0.0
JAGUAR,OTHER,2001,47,23,48.9,24,51.1,0,0.0
JAGUAR,OTHER,2002,42,18,42.9,24,57.1,0,0.0
JAGUAR,OTHER,2003,45,23,51.1,22,48.9,0,0.0
JAGUAR,OTHER,2004,56,26,46.4,30,53.6,0,0.0
JAGUAR,OTHER,2005,39,18,46.2,21,53.8,0,0.0
JAGUAR,OTHER,2006,18,11,61.1,7,38.9,0,0.0
JAGUAR,OTHER,2007,25,13,52.0,12,48.0,0,0.0
JAGUAR,OTHER,2008,35,14,40.0,21,60.0,0,0.0
JAGUAR,OTHER,2009,10,4,40.0,6,60.0,0,0.0
JAGUAR,OTHER,2010,20,16,80.0,4,20.0,0,0.0
JAGUAR,OTHER,2011,6,4,66.7,2,33.3,0,0.0
JAGUAR,OTHER,2012,13,11,84.6,2,15.4,0,0.0
JAGUAR,OTHER,2013,1,1,100.0,0,0.0,0,0.0
JAGUAR,OTHER,2014,12,10,83.3,2,16.7,0,0.0
JAGUAR,OTHER,2015,1,1,100.0,0,0.0,0,0.0
JAGUAR,S-TYPE,1999,3,3,100.0,0,0.0,0,0.0
JAGUAR,S-TYPE,2000,24,14,58.3,10,41.7,0,0.0
JAGUAR,S-TYPE,2001,15,7,46.7,8,53.3,0,0.0
JAGUAR,S-TYPE,2002,35,11,31.4,24,68.6,0,0.0
JAGUAR,S-TYPE,2003,58,27,46.6,31,53.4,0,0.0
JAGUAR,S-TYPE,2004,62,21,33.9,41,66.1,0,0.0
JAGUAR,S-TYPE,2005,81,36,44.4,45,55.6,0,0.0
JAGUAR,S-TYPE,2006,69,28,40.6,41,59.4,0,0.0
JAGUAR,S-TYPE,2007,50,24,48.0,26,52.0,0,0.0
JAGUAR,S-TYPE,2008,3,3,100.0,0,0.0,0,0.0
JAGUAR,XF,2008,137,65,47.4,72,52.6,0,0.0
JAGUAR,XF,2009,19,9,47.4,10,52.6,0,0.0
JAGUAR,XF,2010,100,55,55.0,45,45.0,0,0.0
JAGUAR,XF,2011,31,19,61.3,12,38.7,0,0.0
JAGUAR,XF,2012,268,193,72.0,75,28.0,0,0.0
JAGUAR,XF,2013,84,63,75.0,21,25.0,0,0.0
JAGUAR,XF,2014,362,259,71.5,103,28.5,0,0.0
JAGUAR,XF,2015,29,25,86.2,4,13.8,0,0.0
JAGUAR,XF,2016,1,0,0.0,1,100.0,0,0.0
JAGUAR,XJ,1978,1,1,100.0,0,0.0,0,0.0
JAGUAR,XJ,1990,1,0,0.0,1,100.0,0,0.0
JAGUAR,XJ,2007,1,0,0.0,1,100.0,0,0.0
JAGUAR,XJ,2008,2,1,50.0,1,50.0,0,0.0
JAGUAR,XJ,2010,20,14,70.0,6,30.0,0,0.0
JAGUAR,XJ,2012,10,8,80.0,2,20.0,0,0.0
JAGUAR,XJ,2014,5,5,100.0,0,0.0,0,0.0
JAGUAR,XJ,2015,1,1,100.0,0,0.0,0,0.0
JAGUAR,XJ,2016,1,0,0.0,1,100.0,0,0.0
JAGUAR,XJ6,1982,1,0,0.0,1,100.0,0,0.0
JAGUAR,XJ6,1983,1,0,0.0,1,100.0,0,0.0
JAGUAR,XJ6,1986,2,2,100.0,0,0.0,0,0.0
JAGUAR,XJ6,1996,1,1,100.0,0,0.0,0,0.0
JAGUAR,XJ6,1997,3,1,33.3,2,66.7,0,0.0
JAGUAR,XJ6,2003,12,5,41.7,7,58.3,0,0.0
JAGUAR,XJ6,2004,5,1,20.0,4,80.0,0,0.0
JAGUAR,XJ6,2005,7,4,57.1,3,42.9,0,0.0
JAGUAR,XJ6,2006,37,17,45.9,20,54.1,0,0.0
JAGUAR,XJ6,2007,31,15,48.4,16,51.6,0,0.0
JAGUAR,XJ6,2008,5,3,60.0,2,40.0,0,0.0
JAGUAR,XJ6,2011,2,0,0.0,2,100.0,0,0.0
JAGUAR,XK,2003,7,4,57.1,3,42.9,0,0.0
JAGUAR,XK,2004,7,4,57.1,3,42.9,0,0.0
JAGUAR,XK,2005,8,4,50.0,4,50.0,0,0.0
JAGUAR,XK,2006,40,27,67.5,13,32.5,0,0.0
JAGUAR,XK,2007,61,40,65.6,21,34.4,0,0.0
JAGUAR,XK,2008,12,9,75.0,3,25.0,0,0.0
JAGUAR,XK,2010,2,1,50.0,1,50.0,0,0.0
JAGUAR,XK,2012,1,1,100.0,0,0.0,0,0.0
JAGUAR,XK,2014,3,1,33.3,2,66.7,0,0.0
JAGUAR,X-TYPE,2002,35,15,42.9,20,57.1,0,0.0
JAGUAR,X-TYPE,2003,68,19,27.9,49,72.1,0,0.0
JAGUAR,X-TYPE,2004,203,76,37.4,127,62.6,0,0.0
JAGUAR,X-TYPE,2005,242,82,33.9,160,66.1,0,0.0
JAGUAR,X-TYPE,2006,184,82,44.6,102,55.4,0,0.0
JAGUAR,X-TYPE,2007,153,60,39.2,93,60.8,0,0.0
JAGUAR,X-TYPE,2008,188,92,48.9,96,51.1,0,0.0
JAGUAR,X-TYPE,2009,104,46,44.2,58,55.8,0,0.0
JAGUAR,X-TYPE,2010,73,47,64.4,26,35.6,0,0.0
JEEP,CHEROKEE,2014,9,8,88.9,1,11.1,0,0.0
JEEP,OTHER,2006,2,2,100.0,0,0.0,0,0.0
JEEP,OTHER,2007,40,11,27.5,29,72.5,0,0.0
JEEP,OTHER,2008,42,10,23.8,32,76.2,0,0.0
JEEP,OTHER,2009,8,2,25.0,6,75.0,0,0.0
JEEP,OTHER,2010,4,1,25.0,3,75.0,0,0.0
JEEP,OTHER,2011,1,1,100.0,0,0.0,0,0.0
JEEP,OTHER,2012,45,21,46.7,24,53.3,0,0.0
JEEP,OTHER,2014,2,0,0.0,2,100.0,0,0.0
JEEP,OTHER,2015,1,1,100.0,0,0.0,0,0.0
JEEP,PATRIOT,2013,1,0,0.0,1,100.0,1,100.0
KIA,CARENS,2002,5,3,60.0,2,40.0,0,0.0
KIA,CARENS,2003,11,2,18.2,9,81.8,0,0.0
KIA,CARENS,2004,38,6,15.8,32,84.2,0,0.0
KIA,CARENS,2005,15,3,20.0,12,80.0,0,0.0
KIA,CARENS,2006,8,2,25.0,6,75.0,0,0.0
KIA,CARENS,2007,129,37,28.7,92,71.3,0,0.0
KIA,CARENS,2008,96,26,27.1,70,72.9,0,0.0
KIA,CARENS,2009,23,8,34.8,15,65.2,0,0.0
KIA,CARENS,2010,14,4,28.6,10,71.4,0,0.0
KIA,CARENS,2011,10,3,30.0,7,70.0,0,0.0
KIA,CARENS,2012,1,1,100.0,0,0.0,0,0.0
KIA,CARENS,2013,41,32,78.0,9,22.0,0,0.0
KIA,CARENS,2014,277,209,75.5,68,24.5,0,0.0
KIA,CARENS,2015,22,18,81.8,4,18.2,1,4.5
KIA,CARNIVAL,2006,2,0,0.0,2,100.0,0,0.0
KIA,CARNIVAL,2007,53,18,34.0,35,66.0,0,0.0
KIA,CARNIVAL,2008,29,10,34.5,19,65.5,0,0.0
KIA,CARNIVAL,2009,7,4,57.1,3,42.9,0,0.0
KIA,CARNIVAL,2010,13,6,46.2,7,53.8,0,0.0
KIA,CARNIVAL,2011,3,0,0.0,3,100.0,0,0.0
KIA,CEED,2006,3,1,33.3,2,66.7,0,0.0
KIA,CEED,2007,766,337,44.0,429,56.0,0,0.0
KIA,CEED,2008,1008,405,40.2,603,59.8,0,0.0
KIA,CEED,2009,515,236,45.8,279,54.2,0,0.0
KIA,CEED,2010,1130,565,50.0,565,50.0,0,0.0
KIA,CEED,2011,338,174,51.5,164,48.5,0,0.0
KIA,CEED,2012,1154,766,66.4,388,33.6,1,0.1
KIA,CEED,2013,515,383,74.4,132,25.6,0,0.0
KIA,CEED,2014,993,816,82.2,177,17.8,0,0.0
KIA,CEED,2015,61,50,82.0,11,18.0,0,0.0
KIA,CEED,2016,8,5,62.5,3,37.5,0,0.0
KIA,CERATO,2004,34,8,23.5,26,76.5,0,0.0
KIA,CERATO,2005,214,71,33.2,143,66.8,0,0.0
KIA,CERATO,2006,273,99,36.3,174,63.7,0,0.0
KIA,CERATO,2007,43,16,37.2,27,62.8,0,0.0
KIA,CERATO,2008,1,0,0.0,1,100.0,0,0.0
KIA,CERATO,2014,1,0,0.0,1,100.0,0,0.0
KIA,MAGENTIS,2004,6,2,33.3,4,66.7,0,0.0
KIA,MAGENTIS,2005,5,2,40.0,3,60.0,0,0.0
KIA,MAGENTIS,2006,42,12,28.6,30,71.4,0,0.0
KIA,MAGENTIS,2007,37,15,40.5,22,59.5,0,0.0
KIA,MAGENTIS,2008,12,0,0.0,12,100.0,0,0.0
KIA,MAGENTIS,2009,26,9,34.6,17,65.4,0,0.0
KIA,MAGENTIS,2010,21,9,42.9,12,57.1,0,0.0
KIA,MAGENTIS,2011,2,0,0.0,2,100.0,0,0.0
KIA,MENTOR,1996,1,0,0.0,1,100.0,0,0.0
KIA,MENTOR,2001,1,0,0.0,1,100.0,0,0.0
KIA,MENTOR,2003,2,1,50.0,1,50.0,0,0.0
KIA,NIRO,2016,2,1,50.0,1,50.0,1,50.0
KIA,OPTIMA,2011,2,2,100.0,0,0.0,0,0.0
KIA,OPTIMA,2012,218,149,68.3,69,31.7,0,0.0
KIA,OPTIMA,2013,45,30,66.7,15,33.3,0,0.0
KIA,OPTIMA,2014,193,153,79.3,40,20.7,1,0.5
KIA,OPTIMA,2015,29,24,82.8,5,17.2,0,0.0
KIA,OPTIMA,2016,7,6,85.7,1,14.3,0,0.0
KIA,OPTIMA,2017,11,11,100.0,0,0.0,0,0.0
KIA,OPTIMA,2018,3,3,100.0,0,0.0,0,0.0
KIA,OTHER,2004,2,1,50.0,1,50.0,0,0.0
KIA,PICANTO,2004,116,37,31.9,79,68.1,0,0.0
KIA,PICANTO,2005,371,166,44.7,205,55.3,0,0.0
KIA,PICANTO,2006,336,155,46.1,181,53.9,0,0.0
KIA,PICANTO,2007,212,93,43.9,119,56.1,0,0.0
KIA,PICANTO,2008,158,69,43.7,89,56.3,0,0.0
KIA,PICANTO,2009,97,39,40.2,58,59.8,0,0.0
KIA,PICANTO,2010,357,213,59.7,144,40.3,0,0.0
KIA,PICANTO,2011,55,35,63.6,20,36.4,0,0.0
KIA,PICANTO,2012,192,128,66.7,64,33.3,0,0.0
KIA,PICANTO,2013,29,23,79.3,6,20.7,0,0.0
KIA,PICANTO,2014,211,176,83.4,35,16.6,0,0.0
KIA,PICANTO,2015,32,25,78.1,7,21.9,0,0.0
KIA,PICANTO,2016,1,1,100.0,0,0.0,0,0.0
KIA,PRIDE,1996,1,1,100.0,0,0.0,0,0.0
KIA,PRIDE,1997,1,0,0.0,1,100.0,0,0.0
KIA,PRIDE,1998,1,0,0.0,1,100.0,0,0.0
KIA,PRO_CEED,2007,6,1,16.7,5,83.3,0,0.0
KIA,PRO_CEED,2008,356,161,45.2,195,54.8,0,0.0
KIA,PRO_CEED,2009,121,42,34.7,79,65.3,0,0.0
KIA,PRO_CEED,2010,360,183,50.8,177,49.2,0,0.0
KIA,PRO_CEED,2011,70,43,61.4,27,38.6,0,0.0
KIA,PRO_CEED,2012,131,78,59.5,53,40.5,0,0.0
KIA,PRO_CEED,2013,46,33,71.7,13,28.3,0,0.0
KIA,PRO_CEED,2014,110,93,84.5,17,15.5,0,0.0
KIA,PRO_CEED,2015,12,9,75.0,3,25.0,0,0.0
KIA,PRO_CEED,2016,1,0,0.0,1,100.0,0,0.0
KIA,RIO,2001,9,1,11.1,8,88.9,0,0.0
KIA,RIO,2002,28,6,21.4,22,78.6,0,0.0
KIA,RIO,2003,96,30,31.3,66,68.8,0,0.0
KIA,RIO,2004,256,86,33.6,170,66.4,0,0.0
KIA,RIO,2005,224,87,38.8,137,61.2,0,0.0
KIA,RIO,2006,751,321,42.7,430,57.3,0,0.0
KIA,RIO,2007,707,326,46.1,381,53.9,1,0.1
KIA,RIO,2008,454,200,44.1,254,55.9,0,0.0
KIA,RIO,2009,271,136,50.2,135,49.8,0,0.0
KIA,RIO,2010,825,475,57.6,350,42.4,0,0.0
KIA,RIO,2011,130,84,64.6,46,35.4,0,0.0
KIA,RIO,2012,605,442,73.1,163,26.9,0,0.0
KIA,RIO,2013,103,69,67.0,34,33.0,0,0.0
KIA,RIO,2014,484,405,83.7,79,16.3,0,0.0
KIA,RIO,2015,42,36,85.7,6,14.3,0,0.0
KIA,RIO,2016,1,1,100.0,0,0.0,0,0.0
KIA,SEDONA,2003,4,1,25.0,3,75.0,0,0.0
KIA,SEDONA,2004,4,1,25.0,3,75.0,0,0.0
KIA,SEDONA,2005,13,1,7.7,12,92.3,0,0.0
KIA,SEDONA,2006,30,7,23.3,23,76.7,0,0.0
KIA,SEDONA,2007,19,7,36.8,12,63.2,0,0.0
KIA,SEDONA,2008,16,9,56.3,7,43.8,0,0.0
KIA,SEDONA,2009,9,4,44.4,5,55.6,0,0.0
KIA,SEDONA,2010,21,11,52.4,10,47.6,0,0.0
KIA,SEDONA,2011,12,7,58.3,5,41.7,0,0.0
KIA,SEDONA,2012,13,7,53.8,6,46.2,0,0.0
KIA,SEDONA,2016,1,0,0.0,1,100.0,0,0.0
KIA,SHUMA,2000,1,0,0.0,1,100.0,0,0.0
KIA,SHUMA,2001,1,0,0.0,1,100.0,0,0.0
KIA,SHUMA,2002,1,0,0.0,1,100.0,0,0.0
KIA,SHUMA,2003,2,0,0.0,2,100.0,0,0.0
KIA,SORENTO,2003,21,4,19.0,17,81.0,0,0.0
KIA,SORENTO,2004,54,10,18.5,44,81.5,0,0.0
KIA,SORENTO,2005,191,50,26.2,141,73.8,0,0.0
KIA,SORENTO,2006,250,68,27.2,182,72.8,0,0.0
KIA,SORENTO,2007,194,65,33.5,129,66.5,0,0.0
KIA,SORENTO,2008,71,29,40.8,42,59.2,0,0.0
KIA,SORENTO,2009,1,0,0.0,1,100.0,0,0.0
KIA,SORENTO,2010,55,19,34.5,36,65.5,0,0.0
KIA,SORENTO,2011,10,6,60.0,4,40.0,0,0.0
KIA,SORENTO,2012,58,35,60.3,23,39.7,0,0.0
KIA,SORENTO,2013,13,7,53.8,6,46.2,0,0.0
KIA,SORENTO,2014,133,90,67.7,43,32.3,0,0.0
KIA,SORENTO,2015,6,5,83.3,1,16.7,0,0.0
KIA,SORENTO,2017,1,1,100.0,0,0.0,0,0.0
KIA,SORENTO,2018,1,1,100.0,0,0.0,0,0.0
KIA,SORENTO 2.5 EX 5DR,2006,1,0,0.0,1,100.0,0,0.0
KIA,SOUL,2009,71,33,46.5,38,53.5,0,0.0
KIA,SOUL,2010,183,98,53.6,85,46.4,0,0.0
KIA,SOUL,2011,43,25,58.1,18,41.9,0,0.0
KIA,SOUL,2012,62,51,82.3,11,17.7,0,0.0
KIA,SOUL,2013,6,4,66.7,2,33.3,0,0.0
KIA,SOUL,2014,75,66,88.0,9,12.0,1,1.3
KIA,SOUL,2015,11,9,81.8,2,18.2,0,0.0
KIA,SPORTAGE,2002,1,1,100.0,0,0.0,0,0.0
KIA,SPORTAGE,2003,3,0,0.0,3,100.0,0,0.0
KIA,SPORTAGE,2004,1,0,0.0,1,100.0,0,0.0
KIA,SPORTAGE,2005,174,64,36.8,110,63.2,0,0.0
KIA,SPORTAGE,2006,566,206,36.4,360,63.6,0,0.0
KIA,SPORTAGE,2007,405,145,35.8,260,64.2,0,0.0
KIA,SPORTAGE,2008,157,58,36.9,99,63.1,1,0.6
KIA,SPORTAGE,2009,31,10,32.3,21,67.7,0,0.0
KIA,SPORTAGE,2010,125,63,50.4,62,49.6,0,0.0
KIA,SPORTAGE,2011,157,94,59.9,63,40.1,1,0.6
KIA,SPORTAGE,2012,1206,846,70.1,360,29.9,2,0.2
KIA,SPORTAGE,2013,295,209,70.8,86,29.2,0,0.0
KIA,SPORTAGE,2014,1965,1623,82.6,342,17.4,0,0.0
KIA,SPORTAGE,2015,261,218,83.5,43,16.5,0,0.0
KIA,SPORTAGE,2016,6,3,50.0,3,50.0,0,0.0
KIA,SPORTAGE,2017,3,3,100.0,0,0.0,0,0.0
KIA,SPORTAGE,2018,1,1,100.0,0,0.0,0,0.0
KIA,SPORTAGE 2.7 EX 5DR,2007,1,1,100.0,0,0.0,0,0.0
KIA,VENGA,2010,168,92,54.8,76,45.2,0,0.0
KIA,VENGA,2011,33,18,54.5,15,45.5,0,0.0
KIA,VENGA,2012,164,120,73.2,44,26.8,0,0.0
KIA,VENGA,2013,45,33,73.3,12,26.7,0,0.0
KIA,VENGA,2014,356,276,77.5,80,22.5,0,0.0
KIA,VENGA,2015,71,59,83.1,12,16.9,0,0.0
KIA,VENGA,2016,1,1,100.0,0,0.0,0,0.0
LADA,RIVA,1986,1,1,100.0,0,0.0,0,0.0
LAMBORGHINI,OTHER,2000,1,0,0.0,1,100.0,0,0.0
LAMBORGHINI,OTHER,2001,1,0,0.0,1,100.0,0,0.0
LAMBORGHINI,OTHER,2004,1,1,100.0,0,0.0,0,0.0
LAMBORGHINI,OTHER,2006,1,1,100.0,0,0.0,0,0.0
LANCIA,OTHER,1981,1,0,0.0,1,100.0,0,0.0
LANCIA,OTHER,1983,1,1,100.0,0,0.0,0,0.0
LANCIA,OTHER,1988,2,1,50.0,1,50.0,0,0.0
LANCIA,OTHER,1990,6,4,66.7,2,33.3,0,0.0
LANCIA,OTHER,1991,2,1,50.0,1,50.0,0,0.0
LANCIA,OTHER,1992,2,2,100.0,0,0.0,0,0.0
LANCIA,OTHER,1993,1,0,0.0,1,100.0,0,0.0
LANCIA,OTHER,1994,2,2,100.0,0,0.0,0,0.0
LANCIA,OTHER,2003,1,0,0.0,1,100.0,0,0.0
LANCIA,THEMA,1989,3,1,33.3,2,66.7,0,0.0
LANCIA,THEMA,1992,1,0,0.0,1,100.0,0,0.0
LANCIA,THEMA,1994,1,1,100.0,0,0.0,0,0.0
LANDROVER,109,1977,1,1,100.0,0,0.0,0,0.0
LANDROVER,90,1984,1,0,0.0,1,100.0,0,0.0
LANDROVER,DEFENDER,1982,1,0,0.0,1,100.0,0,0.0
LANDROVER,DEFENDER,1988,1,0,0.0,1,100.0,0,0.0
LANDROVER,DEFENDER,1989,1,0,0.0,1,100.0,0,0.0
LANDROVER,DEFENDER,1990,1,0,0.0,1,100.0,0,0.0
LANDROVER,DEFENDER,1994,2,0,0.0,2,100.0,0,0.0
LANDROVER,DEFENDER,1995,2,1,50.0,1,50.0,0,0.0
LANDROVER,DEFENDER,1996,6,1,16.7,5,83.3,0,0.0
LANDROVER,DEFENDER,1997,1,0,0.0,1,100.0,0,0.0
LANDROVER,DEFENDER,1998,2,0,0.0,2,100.0,0,0.0
LANDROVER,DEFENDER,1999,2,0,0.0,2,100.0,0,0.0
LANDROVER,DEFENDER,2000,5,1,20.0,4,80.0,0,0.0
LANDROVER,DEFENDER,2001,3,0,0.0,3,100.0,0,0.0
LANDROVER,DEFENDER,2002,6,4,66.7,2,33.3,0,0.0
LANDROVER,DEFENDER,2003,7,3,42.9,4,57.1,0,0.0
LANDROVER,DEFENDER,2004,11,6,54.5,5,45.5,0,0.0
LANDROVER,DEFENDER,2005,14,1,7.1,13,92.9,0,0.0
LANDROVER,DEFENDER,2006,19,8,42.1,11,57.9,0,0.0
LANDROVER,DEFENDER,2007,18,7,38.9,11,61.1,0,0.0
LANDROVER,DEFENDER,2008,19,4,21.1,15,78.9,0,0.0
LANDROVER,DEFENDER,2009,2,1,50.0,1,50.0,0,0.0
LANDROVER,DEFENDER 110,1999,1,0,0.0,1,100.0,0,0.0
LANDROVER,DEFENDER 110,2003,2,0,0.0,2,100.0,0,0.0
LANDROVER,DEFENDER 110,2004,1,0,0.0,1,100.0,0,0.0
LANDROVER,DEFENDER 110,2005,3,0,0.0,3,100.0,0,0.0
LANDROVER,DEFENDER 110,2006,3,1,33.3,2,66.7,0,0.0
LANDROVER,DEFENDER 110 2.5 300 TDI 5DR,1984,2,0,0.0,2,100.0,0,0.0
LANDROVER,DEFENDER 110 2.5 300 TDI 5DR,1994,1,1,100.0,0,0.0,0,0.0
LANDROVER,DEFENDER 110 2.5 300 TDI 5DR,1996,1,0,0.0,1,100.0,0,0.0
LANDROVER,DEFENDER 110 2.5 300 TDI 5DR,1998,1,0,0.0,1,100.0,0,0.0
LANDROVER,DEFENDER 110 2.5 300 TDI 5DR,1999,2,1,50.0,1,50.0,0,0.0
LANDROVER,DEFENDER 110 2.5 300 TDI 5DR,2001,1,1,100.0,0,0.0,0,0.0
LANDROVER,DEFENDER 110 2.5 300 TDI 5DR,2003,2,1,50.0,1,50.0,0,0.0
LANDROVER,DEFENDER 110 2.5 300 TDI 5DR,2004,2,0,0.0,2,100.0,0,0.0
LANDROVER,DEFENDER 110 2.5 300 TDI 5DR,2007,3,1,33.3,2,66.7,0,0.0
LANDROVER,DEFENDER 110 2.5 300 TDI 5DR,2008,1,0,0.0,1,100.0,0,0.0
LANDROVER,DEFENDER 110 2.5 300 TDI 5DR,2012,1,1,100.0,0,0.0,0,0.0
LANDROVER,DEFENDER 110 2.5 300 TDI 5DR,2013,2,2,100.0,0,0.0,0,0.0
LANDROVER,DEFENDER 110 2.5 300 TDI 5DR,2014,1,1,100.0,0,0.0,0,0.0
LANDROVER,DEFENDER 110 TD5,2004,1,1,100.0,0,0.0,0,0.0
LANDROVER,DEFENDER 90,1994,1,0,0.0,1,100.0,0,0.0
LANDROVER,DEFENDER 90 2.5 TD5 XS 3DR,2005,1,1,100.0,0,0.0,0,0.0
LANDROVER,DISCOVERY,1994,1,0,0.0,1,100.0,0,0.0
LANDROVER,DISCOVERY,1998,4,1,25.0,3,75.0,0,0.0
LANDROVER,DISCOVERY,1999,5,1,20.0,4,80.0,0,0.0
LANDROVER,DISCOVERY,2000,3,0,0.0,3,100.0,0,0.0
LANDROVER,DISCOVERY,2001,13,4,30.8,9,69.2,0,0.0
LANDROVER,DISCOVERY,2002,46,14,30.4,32,69.6,0,0.0
LANDROVER,DISCOVERY,2003,88,26,29.5,62,70.5,0,0.0
LANDROVER,DISCOVERY,2004,136,29,21.3,107,78.7,1,0.7
LANDROVER,DISCOVERY,2005,187,59,31.6,128,68.4,0,0.0
LANDROVER,DISCOVERY,2006,195,73,37.4,122,62.6,0,0.0
LANDROVER,DISCOVERY,2007,197,69,35.0,128,65.0,0,0.0
LANDROVER,DISCOVERY,2008,140,44,31.4,96,68.6,0,0.0
LANDROVER,DISCOVERY,2009,7,3,42.9,4,57.1,0,0.0
LANDROVER,DISCOVERY,2010,5,3,60.0,2,40.0,0,0.0
LANDROVER,DISCOVERY,2014,1,1,100.0,0,0.0,0,0.0
LANDROVER,DISCOVERY,2015,4,4,100.0,0,0.0,0,0.0
LANDROVER,DISCOVERY 3 TD V6 S 5DR,2007,2,1,50.0,1,50.0,0,0.0
LANDROVER,DISCOVERY 4,2010,25,17,68.0,8,32.0,0,0.0
LANDROVER,DISCOVERY 4,2011,11,6,54.5,5,45.5,0,0.0
LANDROVER,DISCOVERY 4,2012,51,41,80.4,10,19.6,0,0.0
LANDROVER,DISCOVERY 4,2013,11,7,63.6,4,36.4,0,0.0
LANDROVER,DISCOVERY 4,2014,43,37,86.0,6,14.0,0,0.0
LANDROVER,DISCOVERY 4,2015,1,1,100.0,0,0.0,0,0.0
LANDROVER,DISCOVERY 4,2016,2,2,100.0,0,0.0,0,0.0
LANDROVER,FREELANDER,1998,5,1,20.0,4,80.0,0,0.0
LANDROVER,FREELANDER,1999,4,1,25.0,3,75.0,0,0.0
LANDROVER,FREELANDER,2000,6,0,0.0,6,100.0,0,0.0
LANDROVER,FREELANDER,2001,14,4,28.6,10,71.4,0,0.0
LANDROVER,FREELANDER,2002,146,45,30.8,101,69.2,0,0.0
LANDROVER,FREELANDER,2003,198,57,28.8,141,71.2,1,0.5
LANDROVER,FREELANDER,2004,328,105,32.0,223,68.0,1,0.3
LANDROVER,FREELANDER,2005,366,125,34.2,241,65.8,1,0.3
LANDROVER,FREELANDER,2006,273,106,38.8,167,61.2,1,0.4
LANDROVER,FREELANDER,2007,48,18,37.5,30,62.5,2,4.2
LANDROVER,FREELANDER,2008,26,16,61.5,10,38.5,1,3.8
LANDROVER,FREELANDER,2009,7,5,71.4,2,28.6,0,0.0
LANDROVER,FREELANDER,2010,72,42,58.3,30,41.7,0,0.0
LANDROVER,FREELANDER,2011,8,5,62.5,3,37.5,0,0.0
LANDROVER,FREELANDER,2012,13,8,61.5,5,38.5,0,0.0
LANDROVER,FREELANDER,2013,8,7,87.5,1,12.5,0,0.0
LANDROVER,FREELANDER,2014,11,7,63.6,4,36.4,0,0.0
LANDROVER,FREELANDER 2,2006,1,1,100.0,0,0.0,0,0.0
LANDROVER,FREELANDER 2,2007,464,235,50.6,229,49.4,0,0.0
LANDROVER,FREELANDER 2,2008,139,71,51.1,68,48.9,0,0.0
LANDROVER,FREELANDER 2,2009,14,9,64.3,5,35.7,0,0.0
LANDROVER,FREELANDER 2,2010,1,0,0.0,1,100.0,0,0.0
LANDROVER,FREELANDER 2,2011,32,25,78.1,7,21.9,1,3.1
LANDROVER,FREELANDER 2,2012,94,71,75.5,23,24.5,0,0.0
LANDROVER,FREELANDER 2,2013,8,7,87.5,1,12.5,0,0.0
LANDROVER,FREELANDER 2,2014,27,21,77.8,6,22.2,0,0.0
LANDROVER,FREELANDER 2,2015,1,1,100.0,0,0.0,0,0.0
LANDROVER,FREELANDER 2.0 TD4 E 5DR,2004,1,0,0.0,1,100.0,0,0.0
LANDROVER,OTHER,1982,1,1,100.0,0,0.0,0,0.0
LANDROVER,OTHER,1983,1,1,100.0,0,0.0,0,0.0
LANDROVER,OTHER,1984,5,0,0.0,5,100.0,0,0.0
LANDROVER,OTHER,1985,2,1,50.0,1,50.0,0,0.0
LANDROVER,OTHER,1986,3,0,0.0,3,100.0,0,0.0
LANDROVER,OTHER,1987,4,0,0.0,4,100.0,0,0.0
LANDROVER,OTHER,1988,2,1,50.0,1,50.0,0,0.0
LANDROVER,OTHER,1997,1,0,0.0,1,100.0,0,0.0
LANDROVER,OTHER,2001,1,1,100.0,0,0.0,0,0.0
LANDROVER,OTHER,2002,1,0,0.0,1,100.0,0,0.0
LANDROVER,OTHER,2003,1,0,0.0,1,100.0,0,0.0
LANDROVER,OTHER,2004,3,2,66.7,1,33.3,0,0.0
LANDROVER,OTHER,2005,4,2,50.0,2,50.0,0,0.0
LANDROVER,OTHER,2006,28,7,25.0,21,75.0,0,0.0
LANDROVER,OTHER,2007,31,11,35.5,20,64.5,0,0.0
LANDROVER,OTHER,2008,19,8,42.1,11,57.9,0,0.0
LANDROVER,OTHER,2009,3,2,66.7,1,33.3,0,0.0
LANDROVER,OTHER,2010,1,1,100.0,0,0.0,0,0.0
LANDROVER,OTHER,2012,1,0,0.0,1,100.0,0,0.0
LANDROVER,OTHER,2014,6,6,100.0,0,0.0,0,0.0
LANDROVER,OTHER,2015,4,4,100.0,0,0.0,0,0.0
LANDROVER,RANGE ROVER,1984,2,2,100.0,0,0.0,0,0.0
LANDROVER,RANGE ROVER,1987,1,0,0.0,1,100.0,0,0.0
LANDROVER,RANGE ROVER,1988,1,0,0.0,1,100.0,0,0.0
LANDROVER,RANGE ROVER,1989,1,0,0.0,1,100.0,0,0.0
LANDROVER,RANGE ROVER,1990,1,1,100.0,0,0.0,0,0.0
LANDROVER,RANGE ROVER,1991,1,0,0.0,1,100.0,0,0.0
LANDROVER,RANGE ROVER,1993,3,1,33.3,2,66.7,0,0.0
LANDROVER,RANGE ROVER,1994,3,0,0.0,3,100.0,0,0.0
LANDROVER,RANGE ROVER,1997,2,1,50.0,1,50.0,0,0.0
LANDROVER,RANGE ROVER,1998,3,2,66.7,1,33.3,0,0.0
LANDROVER,RANGE ROVER,1999,3,1,33.3,2,66.7,0,0.0
LANDROVER,RANGE ROVER,2000,3,1,33.3,2,66.7,0,0.0
LANDROVER,RANGE ROVER,2001,8,4,50.0,4,50.0,0,0.0
LANDROVER,RANGE ROVER,2002,26,7,26.9,19,73.1,0,0.0
LANDROVER,RANGE ROVER,2003,27,12,44.4,15,55.6,0,0.0
LANDROVER,RANGE ROVER,2004,54,23,42.6,31,57.4,0,0.0
LANDROVER,RANGE ROVER,2005,141,46,32.6,95,67.4,0,0.0
LANDROVER,RANGE ROVER,2006,290,110,37.9,180,62.1,2,0.7
LANDROVER,RANGE ROVER,2007,305,115,37.7,190,62.3,2,0.7
LANDROVER,RANGE ROVER,2008,198,65,32.8,133,67.2,0,0.0
LANDROVER,RANGE ROVER,2009,5,4,80.0,1,20.0,0,0.0
LANDROVER,RANGE ROVER,2010,16,10,62.5,6,37.5,0,0.0
LANDROVER,RANGE ROVER,2011,15,12,80.0,3,20.0,0,0.0
LANDROVER,RANGE ROVER,2012,286,203,71.0,83,29.0,2,0.7
LANDROVER,RANGE ROVER,2013,67,41,61.2,26,38.8,0,0.0
LANDROVER,RANGE ROVER,2014,370,261,70.5,109,29.5,1,0.3
LANDROVER,RANGE ROVER,2015,30,25,83.3,5,16.7,0,0.0
LANDROVER,RANGE ROVER,2017,1,1,100.0,0,0.0,0,0.0
LANDROVER,RANGE ROVER 2.7 SP V6 HSE 5DR,2006,1,0,0.0,1,100.0,0,0.0
LANDROVER,RANGE ROVER 2.7 SP V6 HSE 5DR,2007,1,1,100.0,0,0.0,0,0.0
LANDROVER,RANGE ROVER 2.7TD SPORT V6 HSE,2006,1,0,0.0,1,100.0,0,0.0
LANDROVER,RANGE ROVER 2.7TD SPORT V6 HSE,2008,1,0,0.0,1,100.0,0,0.0
LANDROVER,RANGE ROVER 2.7TD SPORT V6 S,2006,1,0,0.0,1,100.0,0,0.0
LANDROVER,RANGE ROVER 3.0TD6 VOGUE 5DR,2006,2,0,0.0,2,100.0,0,0.0
LDV,MAXUS,2007,1,1,100.0,0,0.0,0,0.0
LDV,OTHER,2006,1,0,0.0,1,100.0,0,0.0
LEXUS,430,2004,1,0,0.0,1,100.0,0,0.0
LEXUS,430,2007,2,0,0.0,2,100.0,0,0.0
LEXUS,CT200H,2011,47,39,83.0,8,17.0,2,4.3
LEXUS,CT200H,2012,135,110,81.5,25,18.5,1,0.7
LEXUS,CT200H,2013,57,47,82.5,10,17.5,1,1.8
LEXUS,CT200H,2014,219,191,87.2,28,12.8,8,3.7
LEXUS,CT200H,2015,18,17,94.4,1,5.6,0,0.0
LEXUS,CT200H,2016,1,1,100.0,0,0.0,0,0.0
LEXUS,GS 450H,2008,41,21,51.2,20,48.8,0,0.0
LEXUS,GS 450H,2009,2,2,100.0,0,0.0,0,0.0
LEXUS,GS 450H,2010,1,1,100.0,0,0.0,0,0.0
LEXUS,GS250,2013,1,1,100.0,0,0.0,0,0.0
LEXUS,GS300,1996,2,2,100.0,0,0.0,0,0.0
LEXUS,GS300,1998,7,3,42.9,4,57.1,0,0.0
LEXUS,GS300,1999,2,2,100.0,0,0.0,0,0.0
LEXUS,GS300,2000,9,7,77.8,2,22.2,0,0.0
LEXUS,GS300,2001,9,6,66.7,3,33.3,0,0.0
LEXUS,GS300,2002,19,8,42.1,11,57.9,0,0.0
LEXUS,GS300,2003,12,4,33.3,8,66.7,0,0.0
LEXUS,GS300,2004,16,3,18.8,13,81.3,0,0.0
LEXUS,GS300,2005,74,37,50.0,37,50.0,0,0.0
LEXUS,GS300,2006,128,72,56.3,56,43.8,0,0.0
LEXUS,GS300,2007,69,34,49.3,35,50.7,1,1.4
LEXUS,GS300,2008,29,16,55.2,13,44.8,0,0.0
LEXUS,GS300,2009,2,0,0.0,2,100.0,0,0.0
LEXUS,GS300,2010,1,1,100.0,0,0.0,0,0.0
LEXUS,GS300,2013,1,1,100.0,0,0.0,0,0.0
LEXUS,GS300,2014,96,84,87.5,12,12.5,0,0.0
LEXUS,GS300,2015,13,11,84.6,2,15.4,1,7.7
LEXUS,GS300,2016,2,2,100.0,0,0.0,0,0.0
LEXUS,GS300,2017,2,2,100.0,0,0.0,0,0.0
LEXUS,GS300,2018,1,1,100.0,0,0.0,0,0.0
LEXUS,GS430,2001,1,0,0.0,1,100.0,0,0.0
LEXUS,GS430,2005,2,1,50.0,1,50.0,0,0.0
LEXUS,GS450,2008,4,4,100.0,0,0.0,0,0.0
LEXUS,GS450,2009,4,1,25.0,3,75.0,0,0.0
LEXUS,GS450,2010,3,2,66.7,1,33.3,0,0.0
LEXUS,GS450,2011,2,1,50.0,1,50.0,0,0.0
LEXUS,GS450,2012,29,26,89.7,3,10.3,0,0.0
LEXUS,GS450,2013,3,2,66.7,1,33.3,0,0.0
LEXUS,GS450,2014,17,14,82.4,3,17.6,0,0.0
LEXUS,GS450,2015,1,0,0.0,1,100.0,0,0.0
LEXUS,HS,2010,1,1,100.0,0,0.0,0,0.0
LEXUS,IS 200 2.0 SE 4DR,2003,1,1,100.0,0,0.0,0,0.0
LEXUS,IS 200 SPORT,2002,1,1,100.0,0,0.0,0,0.0
LEXUS,IS 220 D 2.2 SEL 4DR,2006,1,1,100.0,0,0.0,0,0.0
LEXUS,IS200,1998,2,0,0.0,2,100.0,0,0.0
LEXUS,IS200,1999,95,29,30.5,66,69.5,0,0.0
LEXUS,IS200,2000,217,53,24.4,164,75.6,1,0.5
LEXUS,IS200,2001,219,54,24.7,165,75.3,0,0.0
LEXUS,IS200,2002,237,75,31.6,162,68.4,0,0.0
LEXUS,IS200,2003,273,101,37.0,172,63.0,0,0.0
LEXUS,IS200,2004,227,79,34.8,148,65.2,0,0.0
LEXUS,IS200,2005,180,77,42.8,103,57.2,0,0.0
LEXUS,IS200,2006,2,0,0.0,2,100.0,0,0.0
LEXUS,IS200,2010,12,8,66.7,4,33.3,0,0.0
LEXUS,IS200,2011,55,38,69.1,17,30.9,0,0.0
LEXUS,IS200,2012,74,60,81.1,14,18.9,0,0.0
LEXUS,IS200,2013,2,1,50.0,1,50.0,0,0.0
LEXUS,IS200,2014,3,2,66.7,1,33.3,0,0.0
LEXUS,IS200,2016,1,1,100.0,0,0.0,0,0.0
LEXUS,IS220,2006,29,11,37.9,18,62.1,0,0.0
LEXUS,IS220,2007,33,15,45.5,18,54.5,0,0.0
LEXUS,IS220,2008,93,54,58.1,39,41.9,0,0.0
LEXUS,IS220,2009,39,25,64.1,14,35.9,0,0.0
LEXUS,IS220,2010,131,89,67.9,42,32.1,1,0.8
LEXUS,IS220,2011,2,2,100.0,0,0.0,0,0.0
LEXUS,IS250,2005,10,5,50.0,5,50.0,0,0.0
LEXUS,IS250,2006,296,186,62.8,110,37.2,0,0.0
LEXUS,IS250,2007,250,173,69.2,77,30.8,0,0.0
LEXUS,IS250,2008,80,57,71.3,23,28.8,1,1.3
LEXUS,IS250,2009,12,10,83.3,2,16.7,0,0.0
LEXUS,IS250,2010,14,10,71.4,4,28.6,0,0.0
LEXUS,IS250,2011,2,2,100.0,0,0.0,0,0.0
LEXUS,IS250,2012,3,3,100.0,0,0.0,0,0.0
LEXUS,IS300,2002,1,1,100.0,0,0.0,0,0.0
LEXUS,IS300,2004,1,0,0.0,1,100.0,0,0.0
LEXUS,IS300,2013,59,41,69.5,18,30.5,2,3.4
LEXUS,IS300,2014,513,416,81.1,97,18.9,5,1.0
LEXUS,IS300,2015,40,35,87.5,5,12.5,0,0.0
LEXUS,IS300,2016,1,1,100.0,0,0.0,0,0.0
LEXUS,IS300,2017,1,1,100.0,0,0.0,0,0.0
LEXUS,IS300H,2016,1,0,0.0,1,100.0,0,0.0
LEXUS,LS400,1998,1,0,0.0,1,100.0,0,0.0
LEXUS,LS460,2006,3,1,33.3,2,66.7,0,0.0
LEXUS,LS460,2007,65,30,46.2,35,53.8,1,1.5
LEXUS,LS460,2008,9,5,55.6,4,44.4,0,0.0
LEXUS,LS460,2009,1,0,0.0,1,100.0,0,0.0
LEXUS,LS600,2007,1,1,100.0,0,0.0,0,0.0
LEXUS,LS600,2012,1,1,100.0,0,0.0,0,0.0
LEXUS,LS600,2014,1,1,100.0,0,0.0,0,0.0
LEXUS,NX,2015,1,1,100.0,0,0.0,0,0.0
LEXUS,NX300,2014,2,1,50.0,1,50.0,0,0.0
LEXUS,NX300,2015,3,2,66.7,1,33.3,0,0.0
LEXUS,NX300H,2014,3,3,100.0,0,0.0,0,0.0
LEXUS,NX300H,2015,1,1,100.0,0,0.0,0,0.0
LEXUS,OTHER,1992,2,1,50.0,1,50.0,0,0.0
LEXUS,OTHER,1994,2,0,0.0,2,100.0,0,0.0
LEXUS,OTHER,1995,1,1,100.0,0,0.0,0,0.0
LEXUS,OTHER,1996,3,2,66.7,1,33.3,0,0.0
LEXUS,OTHER,1997,6,5,83.3,1,16.7,0,0.0
LEXUS,OTHER,1998,6,3,50.0,3,50.0,0,0.0
LEXUS,OTHER,1999,8,0,0.0,8,100.0,0,0.0
LEXUS,OTHER,2000,13,4,30.8,9,69.2,0,0.0
LEXUS,OTHER,2001,48,22,45.8,26,54.2,0,0.0
LEXUS,OTHER,2002,39,21,53.8,18,46.2,0,0.0
LEXUS,OTHER,2003,43,21,48.8,22,51.2,0,0.0
LEXUS,OTHER,2004,91,48,52.7,43,47.3,1,1.1
LEXUS,OTHER,2005,105,64,61.0,41,39.0,0,0.0
LEXUS,OTHER,2006,587,298,50.8,289,49.2,2,0.3
LEXUS,OTHER,2007,728,378,51.9,350,48.1,5,0.7
LEXUS,OTHER,2008,374,218,58.3,156,41.7,1,0.3
LEXUS,OTHER,2009,82,57,69.5,25,30.5,0,0.0
LEXUS,OTHER,2010,42,31,73.8,11,26.2,1,2.4
LEXUS,OTHER,2011,4,4,100.0,0,0.0,0,0.0
LEXUS,OTHER,2012,71,62,87.3,9,12.7,1,1.4
LEXUS,OTHER,2013,7,5,71.4,2,28.6,1,14.3
LEXUS,OTHER,2014,42,35,83.3,7,16.7,0,0.0
LEXUS,OTHER,2015,17,13,76.5,4,23.5,1,5.9
LEXUS,RX 350,2007,1,1,100.0,0,0.0,0,0.0
LEXUS,RX300,2001,1,0,0.0,1,100.0,0,0.0
LEXUS,RX300,2002,1,1,100.0,0,0.0,0,0.0
LEXUS,RX300,2005,2,1,50.0,1,50.0,0,0.0
LEXUS,RX400,2005,1,1,100.0,0,0.0,0,0.0
LEXUS,RX400,2006,2,1,50.0,1,50.0,0,0.0
LEXUS,RX400,2007,5,4,80.0,1,20.0,0,0.0
LEXUS,RX400,2008,2,2,100.0,0,0.0,0,0.0
LEXUS,RX450,2009,2,1,50.0,1,50.0,0,0.0
LEXUS,RX450,2010,142,96,67.6,46,32.4,0,0.0
LEXUS,RX450,2011,27,21,77.8,6,22.2,1,3.7
LEXUS,RX450,2012,64,50,78.1,14,21.9,0,0.0
LEXUS,RX450,2013,17,16,94.1,1,5.9,0,0.0
LEXUS,RX450,2014,66,60,90.9,6,9.1,1,1.5
LEXUS,RX450,2015,6,6,100.0,0,0.0,0,0.0
LEYLAND,MGB,1980,2,0,0.0,2,100.0,0,0.0
LEYLAND,MGB,1981,1,0,0.0,1,100.0,0,0.0
LEYLAND,MINI,1980,5,1,20.0,4,80.0,0,0.0
LEYLAND,MINI,1981,2,1,50.0,1,50.0,0,0.0
LEYLAND,MINI,1983,2,0,0.0,2,100.0,0,0.0
LEYLAND,MINI,1984,2,2,100.0,0,0.0,0,0.0
LEYLAND,MINI,1988,1,0,0.0,1,100.0,0,0.0
LEYLAND,MINI,1989,2,1,50.0,1,50.0,0,0.0
LEYLAND,MINI,1990,4,1,25.0,3,75.0,0,0.0
LEYLAND,MINI,1991,1,0,0.0,1,100.0,0,0.0
LEYLAND,MINI,1992,2,1,50.0,1,50.0,0,0.0
LEYLAND,MINI,1993,5,3,60.0,2,40.0,0,0.0
LEYLAND,MINI,1994,9,1,11.1,8,88.9,0,0.0
LEYLAND,MINI,1995,5,2,40.0,3,60.0,0,0.0
LEYLAND,MINI,1996,5,2,40.0,3,60.0,0,0.0
LEYLAND,MINI,1997,1,1,100.0,0,0.0,0,0.0
LEYLAND,MINI,1999,2,2,100.0,0,0.0,0,0.0
LEYLAND,MINI,2000,1,0,0.0,1,100.0,0,0.0
LINCOLN,TOWNCAR,2000,3,1,33.3,2,66.7,0,0.0
LINCOLN,TOWNCAR,2003,5,1,20.0,4,80.0,0,0.0
LOTUS,ELISE,2003,1,1,100.0,0,0.0,0,0.0
LOTUS,ELISE,2004,1,0,0.0,1,100.0,0,0.0
LOTUS,OTHER,1970,1,0,0.0,1,100.0,0,0.0
LOTUS,OTHER,1987,1,0,0.0,1,100.0,0,0.0
LOTUS,OTHER,1988,2,1,50.0,1,50.0,0,0.0
LOTUS,OTHER,1990,1,1,100.0,0,0.0,0,0.0
LOTUS,OTHER,1991,1,0,0.0,1,100.0,0,0.0
LOTUS,OTHER,1996,4,0,0.0,4,100.0,0,0.0
LOTUS,OTHER,1997,1,1,100.0,0,0.0,0,0.0
LOTUS,OTHER,1998,1,0,0.0,1,100.0,0,0.0
LOTUS,OTHER,1999,5,2,40.0,3,60.0,0,0.0
LOTUS,OTHER,2000,1,0,0.0,1,100.0,0,0.0
LOTUS,OTHER,2001,4,2,50.0,2,50.0,0,0.0
LOTUS,OTHER,2002,8,2,25.0,6,75.0,0,0.0
LOTUS,OTHER,2003,1,1,100.0,0,0.0,0,0.0
LOTUS,OTHER,2004,3,0,0.0,3,100.0,0,0.0
LOTUS,OTHER,2005,11,5,45.5,6,54.5,0,0.0
LOTUS,OTHER,2006,1,0,0.0,1,100.0,0,0.0
LOTUS,OTHER,2007,6,3,50.0,3,50.0,0,0.0
LOTUS,OTHER,2008,2,1,50.0,1,50.0,0,0.0
LTI,TXI SILVER LONDON TAXI 4DR A,1997,2,2,100.0,0,0.0,0,0.0
MAKE UNSPECIFIED,OTHER,1997,1,0,0.0,1,100.0,0,0.0
MAKE UNSPECIFIED,OTHER,1998,1,0,0.0,1,100.0,0,0.0
MAKE UNSPECIFIED,OTHER,1999,3,3,100.0,0,0.0,0,0.0
MAKE UNSPECIFIED,OTHER,2000,6,2,33.3,4,66.7,0,0.0
MAKE UNSPECIFIED,OTHER,2001,3,2,66.7,1,33.3,0,0.0
MAKE UNSPECIFIED,OTHER,2002,2,2,100.0,0,0.0,0,0.0
MAKE UNSPECIFIED,OTHER,2003,1,1,100.0,0,0.0,0,0.0
MAKE UNSPECIFIED,OTHER,2004,4,1,25.0,3,75.0,0,0.0
MAKE UNSPECIFIED,UNKNOWN MODEL,1980,1,0,0.0,1,100.0,0,0.0
MAKE UNSPECIFIED,UNKNOWN MODEL,1984,1,1,100.0,0,0.0,0,0.0
MAKE UNSPECIFIED,UNKNOWN MODEL,1985,2,1,50.0,1,50.0,0,0.0
MAKE UNSPECIFIED,UNKNOWN MODEL,1987,5,2,40.0,3,60.0,0,0.0
MAKE UNSPECIFIED,UNKNOWN MODEL,1988,4,4,100.0,0,0.0,0,0.0
MAKE UNSPECIFIED,UNKNOWN MODEL,1989,10,4,40.0,6,60.0,1,10.0
MAKE UNSPECIFIED,UNKNOWN MODEL,1990,7,0,0.0,7,100.0,0,0.0
MAKE UNSPECIFIED,UNKNOWN MODEL,1991,15,7,46.7,8,53.3,0,0.0
MAKE UNSPECIFIED,UNKNOWN MODEL,1992,4,2,50.0,2,50.0,0,0.0
MAKE UNSPECIFIED,UNKNOWN MODEL,1993,6,1,16.7,5,83.3,0,0.0
MAKE UNSPECIFIED,UNKNOWN MODEL,1994,6,4,66.7,2,33.3,0,0.0
MAKE UNSPECIFIED,UNKNOWN MODEL,1995,10,3,30.0,7,70.0,0,0.0
MAKE UNSPECIFIED,UNKNOWN MODEL,1996,4,0,0.0,4,100.0,0,0.0
MAKE UNSPECIFIED,UNKNOWN MODEL,1997,6,2,33.3,4,66.7,0,0.0
MAKE UNSPECIFIED,UNKNOWN MODEL,1998,8,3,37.5,5,62.5,0,0.0
MAKE UNSPECIFIED,UNKNOWN MODEL,1999,7,2,28.6,5,71.4,0,0.0
MAKE UNSPECIFIED,UNKNOWN MODEL,2000,10,4,40.0,6,60.0,0,0.0
MAKE UNSPECIFIED,UNKNOWN MODEL,2001,6,2,33.3,4,66.7,0,0.0
MAKE UNSPECIFIED,UNKNOWN MODEL,2002,10,3,30.0,7,70.0,0,0.0
MAKE UNSPECIFIED,UNKNOWN MODEL,2003,25,8,32.0,17,68.0,0,0.0
MAKE UNSPECIFIED,UNKNOWN MODEL,2004,26,11,42.3,15,57.7,0,0.0
MAKE UNSPECIFIED,UNKNOWN MODEL,2005,46,9,19.6,37,80.4,0,0.0
MAKE UNSPECIFIED,UNKNOWN MODEL,2006,50,14,28.0,36,72.0,0,0.0
MAKE UNSPECIFIED,UNKNOWN MODEL,2007,34,13,38.2,21,61.8,0,0.0
MAKE UNSPECIFIED,UNKNOWN MODEL,2008,14,2,14.3,12,85.7,2,14.3
MASERATI,GHIBLI,2014,11,6,54.5,5,45.5,0,0.0
MASERATI,GHIBLI,2015,1,1,100.0,0,0.0,0,0.0
MASERATI,OTHER,1990,1,1,100.0,0,0.0,0,0.0
MASERATI,OTHER,1999,1,0,0.0,1,100.0,0,0.0
MASERATI,OTHER,2000,2,1,50.0,1,50.0,0,0.0
MASERATI,OTHER,2001,1,1,100.0,0,0.0,0,0.0
MASERATI,OTHER,2003,6,4,66.7,2,33.3,0,0.0
MASERATI,OTHER,2004,5,2,40.0,3,60.0,0,0.0
MASERATI,OTHER,2005,6,4,66.7,2,33.3,0,0.0
MASERATI,OTHER,2006,11,4,36.4,7,63.6,0,0.0
MASERATI,OTHER,2007,10,6,60.0,4,40.0,0,0.0
MASERATI,OTHER,2008,10,6,60.0,4,40.0,0,0.0
MASERATI,OTHER,2009,4,0,0.0,4,100.0,0,0.0
MASERATI,OTHER,2011,3,1,33.3,2,66.7,0,0.0
MASERATI,OTHER,2014,4,1,25.0,3,75.0,0,0.0
MASERATI,QUATTROPORTE,2010,1,1,100.0,0,0.0,0,0.0
MASERATI,QUATTROPORTE,2013,2,2,100.0,0,0.0,0,0.0
MASERATI,QUATTROPORTE,2014,3,0,0.0,3,100.0,0,0.0
MAZDA,121,1989,3,1,33.3,2,66.7,0,0.0
MAZDA,121,1990,1,1,100.0,0,0.0,0,0.0
MAZDA,121,1991,1,0,0.0,1,100.0,0,0.0
MAZDA,121,1992,1,0,0.0,1,100.0,0,0.0
MAZDA,121,1993,1,1,100.0,0,0.0,0,0.0
MAZDA,121,1994,2,0,0.0,2,100.0,0,0.0
MAZDA,121,1995,1,0,0.0,1,100.0,0,0.0
MAZDA,121,1996,7,2,28.6,5,71.4,0,0.0
MAZDA,121,1997,3,1,33.3,2,66.7,0,0.0
MAZDA,121,1998,15,2,13.3,13,86.7,0,0.0
MAZDA,121,1999,6,3,50.0,3,50.0,0,0.0
MAZDA,121,2001,33,9,27.3,24,72.7,0,0.0
MAZDA,121,2002,21,6,28.6,15,71.4,0,0.0
MAZDA,121,2003,13,3,23.1,10,76.9,0,0.0
MAZDA,121,2004,3,2,66.7,1,33.3,0,0.0
MAZDA,121,2005,1,0,0.0,1,100.0,0,0.0
MAZDA,2,2003,8,1,12.5,7,87.5,0,0.0
MAZDA,2,2004,29,10,34.5,19,65.5,0,0.0
MAZDA,2,2005,105,51,48.6,54,51.4,0,0.0
MAZDA,2,2006,188,105,55.9,83,44.1,0,0.0
MAZDA,2,2007,241,135,56.0,106,44.0,0,0.0
MAZDA,2,2008,374,213,57.0,161,43.0,0,0.0
MAZDA,2,2009,190,109,57.4,81,42.6,0,0.0
MAZDA,2,2010,521,373,71.6,148,28.4,0,0.0
MAZDA,2,2011,83,55,66.3,28,33.7,0,0.0
MAZDA,2,2012,204,165,80.9,39,19.1,0,0.0
MAZDA,2,2013,38,30,78.9,8,21.1,0,0.0
MAZDA,2,2014,115,106,92.2,9,7.8,0,0.0
MAZDA,2,2015,13,11,84.6,2,15.4,0,0.0
MAZDA,3,2003,1,0,0.0,1,100.0,0,0.0
MAZDA,3,2004,1110,398,35.9,712,64.1,0,0.0
MAZDA,3,2005,1296,528,40.7,768,59.3,0,0.0
MAZDA,3,2006,1131,509,45.0,622,55.0,0,0.0
MAZDA,3,2007,1433,635,44.3,798,55.7,0,0.0
MAZDA,3,2008,730,360,49.3,370,50.7,1,0.1
MAZDA,3,2009,263,134,51.0,129,49.0,0,0.0
MAZDA,3,2010,1032,599,58.0,433,42.0,0,0.0
MAZDA,3,2011,145,97,66.9,48,33.1,0,0.0
MAZDA,3,2012,500,398,79.6,102,20.4,0,0.0
MAZDA,3,2013,83,67,80.7,16,19.3,0,0.0
MAZDA,3,2014,624,550,88.1,74,11.9,0,0.0
MAZDA,3,2015,84,75,89.3,9,10.7,0,0.0
MAZDA,3,2016,1,0,0.0,1,100.0,0,0.0
MAZDA,3 EXECUTIVE 105PS,1998,1,1,100.0,0,0.0,0,0.0
MAZDA,3 EXECUTIVE 105PS,2012,1,1,100.0,0,0.0,0,0.0
MAZDA,323,1985,1,0,0.0,1,100.0,0,0.0
MAZDA,323,1986,3,2,66.7,1,33.3,0,0.0
MAZDA,323,1988,1,0,0.0,1,100.0,0,0.0
MAZDA,323,1990,8,5,62.5,3,37.5,0,0.0
MAZDA,323,1991,4,2,50.0,2,50.0,0,0.0
MAZDA,323,1992,6,4,66.7,2,33.3,0,0.0
MAZDA,323,1993,7,3,42.9,4,57.1,0,0.0
MAZDA,323,1994,15,3,20.0,12,80.0,0,0.0
MAZDA,323,1995,11,2,18.2,9,81.8,0,0.0
MAZDA,323,1996,23,10,43.5,13,56.5,0,0.0
MAZDA,323,1997,76,28,36.8,48,63.2,0,0.0
MAZDA,323,1998,131,38,29.0,93,71.0,0,0.0
MAZDA,323,1999,187,57,30.5,130,69.5,0,0.0
MAZDA,323,2000,314,95,30.3,219,69.7,0,0.0
MAZDA,323,2001,299,103,34.4,196,65.6,0,0.0
MAZDA,323,2002,267,103,38.6,164,61.4,0,0.0
MAZDA,323,2003,259,76,29.3,183,70.7,0,0.0
MAZDA,323,2004,22,11,50.0,11,50.0,0,0.0
MAZDA,323,2005,2,0,0.0,2,100.0,0,0.0
MAZDA,323,2012,2,2,100.0,0,0.0,0,0.0
MAZDA,6,2002,54,14,25.9,40,74.1,0,0.0
MAZDA,6,2003,356,115,32.3,241,67.7,0,0.0
MAZDA,6,2004,446,144,32.3,302,67.7,0,0.0
MAZDA,6,2005,573,197,34.4,376,65.6,0,0.0
MAZDA,6,2006,575,226,39.3,349,60.7,0,0.0
MAZDA,6,2007,577,272,47.1,305,52.9,0,0.0
MAZDA,6,2008,1161,486,41.9,675,58.1,2,0.2
MAZDA,6,2009,475,224,47.2,251,52.8,1,0.2
MAZDA,6,2010,764,449,58.8,315,41.2,0,0.0
MAZDA,6,2011,157,95,60.5,62,39.5,0,0.0
MAZDA,6,2012,391,282,72.1,109,27.9,0,0.0
MAZDA,6,2013,162,123,75.9,39,24.1,0,0.0
MAZDA,6,2014,952,764,80.3,188,19.7,0,0.0
MAZDA,6,2015,80,69,86.3,11,13.8,0,0.0
MAZDA,6,2016,5,4,80.0,1,20.0,0,0.0
MAZDA,6,2017,4,4,100.0,0,0.0,0,0.0
MAZDA,6 2.0 TS 5DR A,2005,1,0,0.0,1,100.0,0,0.0
MAZDA,626,1988,1,1,100.0,0,0.0,0,0.0
MAZDA,626,1991,1,0,0.0,1,100.0,0,0.0
MAZDA,626,1993,1,0,0.0,1,100.0,0,0.0
MAZDA,626,1994,1,1,100.0,0,0.0,0,0.0
MAZDA,626,1995,2,1,50.0,1,50.0,0,0.0
MAZDA,626,1996,4,1,25.0,3,75.0,0,0.0
MAZDA,626,1997,6,4,66.7,2,33.3,0,0.0
MAZDA,626,1998,20,10,50.0,10,50.0,0,0.0
MAZDA,626,1999,32,10,31.3,22,68.8,0,0.0
MAZDA,626,2000,63,25,39.7,38,60.3,0,0.0
MAZDA,626,2001,52,16,30.8,36,69.2,0,0.0
MAZDA,626,2002,21,7,33.3,14,66.7,0,0.0
MAZDA,626,2003,4,2,50.0,2,50.0,0,0.0
MAZDA,ATENZA,2011,1,1,100.0,0,0.0,0,0.0
MAZDA,AXELA,2007,4,1,25.0,3,75.0,0,0.0
MAZDA,AXELA,2008,3,2,66.7,1,33.3,0,0.0
MAZDA,AXELA,2009,4,2,50.0,2,50.0,0,0.0
MAZDA,AXELA,2010,2,1,50.0,1,50.0,0,0.0
MAZDA,AXELA,2011,1,1,100.0,0,0.0,0,0.0
MAZDA,AXELA,2013,1,1,100.0,0,0.0,0,0.0
MAZDA,AXELA,2016,1,1,100.0,0,0.0,0,0.0
MAZDA,BIANTE,2008,3,1,33.3,2,66.7,0,0.0
MAZDA,BIANTE,2009,2,2,100.0,0,0.0,0,0.0
MAZDA,BIANTE,2010,4,3,75.0,1,25.0,0,0.0
MAZDA,BIANTE,2012,1,1,100.0,0,0.0,0,0.0
MAZDA,BONGO,2001,1,1,100.0,0,0.0,0,0.0
MAZDA,CAPELLA 2.0 GFEP,2001,1,1,100.0,0,0.0,0,0.0
MAZDA,CX-5,2012,78,64,82.1,14,17.9,0,0.0
MAZDA,CX-5,2013,69,59,85.5,10,14.5,0,0.0
MAZDA,CX-5,2014,445,388,87.2,57,12.8,1,0.2
MAZDA,CX-5,2015,65,63,96.9,2,3.1,0,0.0
MAZDA,CX-7,2007,1,0,0.0,1,100.0,0,0.0
MAZDA,CX-7,2008,2,1,50.0,1,50.0,0,0.0
MAZDA,CX-7,2010,1,1,100.0,0,0.0,0,0.0
MAZDA,CX-7,2011,2,0,0.0,2,100.0,0,0.0
MAZDA,CX-7,2012,1,1,100.0,0,0.0,0,0.0
MAZDA,DEMIO,1997,2,0,0.0,2,100.0,0,0.0
MAZDA,DEMIO,1998,28,13,46.4,15,53.6,0,0.0
MAZDA,DEMIO,1999,128,41,32.0,87,68.0,0,0.0
MAZDA,DEMIO,2000,121,37,30.6,84,69.4,0,0.0
MAZDA,DEMIO,2001,60,24,40.0,36,60.0,0,0.0
MAZDA,DEMIO,2002,75,26,34.7,49,65.3,0,0.0
MAZDA,DEMIO,2003,66,29,43.9,37,56.1,0,0.0
MAZDA,DEMIO,2004,37,19,51.4,18,48.6,0,0.0
MAZDA,DEMIO,2005,31,10,32.3,21,67.7,0,0.0
MAZDA,DEMIO,2006,27,16,59.3,11,40.7,0,0.0
MAZDA,DEMIO,2007,36,22,61.1,14,38.9,0,0.0
MAZDA,DEMIO,2008,65,45,69.2,20,30.8,0,0.0
MAZDA,DEMIO,2009,81,51,63.0,30,37.0,0,0.0
MAZDA,DEMIO,2010,69,47,68.1,22,31.9,0,0.0
MAZDA,DEMIO,2011,42,26,61.9,16,38.1,0,0.0
MAZDA,DEMIO,2012,25,20,80.0,5,20.0,0,0.0
MAZDA,DEMIO,2013,9,4,44.4,5,55.6,0,0.0
MAZDA,DEMIO,2016,4,1,25.0,3,75.0,0,0.0
MAZDA,EUNOS-ROADSTER NA6CE 2DR,1990,1,1,100.0,0,0.0,0,0.0
MAZDA,EUNOS-ROADSTER NA6CE 2DR,1992,1,1,100.0,0,0.0,0,0.0
MAZDA,EUNOS-ROADSTER NB6C 2DR,1999,1,1,100.0,0,0.0,0,0.0
MAZDA,EUNOS-ROADSTER NB6C 2DR,2008,1,1,100.0,0,0.0,0,0.0
MAZDA,EUNOS-ROADSTER NB6C 2DR,2010,3,1,33.3,2,66.7,0,0.0
MAZDA,EUNOS-ROADSTER NB6C 2DR,2011,1,1,100.0,0,0.0,0,0.0
MAZDA,EUNOS-ROADSTER NB8C 2DR,2006,1,1,100.0,0,0.0,0,0.0
MAZDA,MAZDA 5,2005,17,6,35.3,11,64.7,0,0.0
MAZDA,MAZDA 5,2006,323,102,31.6,221,68.4,0,0.0
MAZDA,MAZDA 5,2007,458,143,31.2,315,68.8,0,0.0
MAZDA,MAZDA 5,2008,237,67,28.3,170,71.7,0,0.0
MAZDA,MAZDA 5,2009,43,20,46.5,23,53.5,0,0.0
MAZDA,MAZDA 5,2010,68,32,47.1,36,52.9,0,0.0
MAZDA,MAZDA 5,2011,30,15,50.0,15,50.0,0,0.0
MAZDA,MAZDA 5,2012,113,65,57.5,48,42.5,0,0.0
MAZDA,MAZDA 5,2013,14,6,42.9,8,57.1,0,0.0
MAZDA,MAZDA 5,2014,69,53,76.8,16,23.2,0,0.0
MAZDA,MAZDA 5,2015,5,5,100.0,0,0.0,0,0.0
MAZDA,MPV,1996,1,1,100.0,0,0.0,0,0.0
MAZDA,MPV,1998,2,0,0.0,2,100.0,0,0.0
MAZDA,MPV,2000,1,1,100.0,0,0.0,0,0.0
MAZDA,MPV,2001,9,4,44.4,5,55.6,0,0.0
MAZDA,MPV,2002,10,2,20.0,8,80.0,0,0.0
MAZDA,MPV,2004,1,0,0.0,1,100.0,0,0.0
MAZDA,MPV,2005,2,1,50.0,1,50.0,0,0.0
MAZDA,MPV,2006,1,1,100.0,0,0.0,0,0.0
MAZDA,MPV,2008,1,1,100.0,0,0.0,0,0.0
MAZDA,MX,1990,4,0,0.0,4,100.0,0,0.0
MAZDA,MX,1991,4,3,75.0,1,25.0,0,0.0
MAZDA,MX,1992,9,6,66.7,3,33.3,0,0.0
MAZDA,MX,1993,2,1,50.0,1,50.0,0,0.0
MAZDA,MX,1994,2,1,50.0,1,50.0,0,0.0
MAZDA,MX,1995,5,2,40.0,3,60.0,0,0.0
MAZDA,MX,1996,6,4,66.7,2,33.3,0,0.0
MAZDA,MX,1997,21,12,57.1,9,42.9,0,0.0
MAZDA,MX,1998,44,24,54.5,20,45.5,0,0.0
MAZDA,MX,1999,47,28,59.6,19,40.4,0,0.0
MAZDA,MX,2000,57,26,45.6,31,54.4,0,0.0
MAZDA,MX,2001,40,20,50.0,20,50.0,0,0.0
MAZDA,MX,2002,26,12,46.2,14,53.8,0,0.0
MAZDA,MX,2003,28,15,53.6,13,46.4,0,0.0
MAZDA,MX,2004,21,12,57.1,9,42.9,0,0.0
MAZDA,MX,2005,1,1,100.0,0,0.0,0,0.0
MAZDA,MX-5,1990,9,1,11.1,8,88.9,0,0.0
MAZDA,MX-5,1991,12,2,16.7,10,83.3,0,0.0
MAZDA,MX-5,1992,6,3,50.0,3,50.0,0,0.0
MAZDA,MX-5,1993,4,3,75.0,1,25.0,0,0.0
MAZDA,MX-5,1994,1,0,0.0,1,100.0,0,0.0
MAZDA,MX-5,1995,2,2,100.0,0,0.0,0,0.0
MAZDA,MX-5,1996,13,6,46.2,7,53.8,0,0.0
MAZDA,MX-5,1997,5,4,80.0,1,20.0,0,0.0
MAZDA,MX-5,1998,15,6,40.0,9,60.0,0,0.0
MAZDA,MX-5,1999,10,4,40.0,6,60.0,0,0.0
MAZDA,MX-5,2000,11,7,63.6,4,36.4,0,0.0
MAZDA,MX-5,2001,9,5,55.6,4,44.4,0,0.0
MAZDA,MX-5,2002,20,9,45.0,11,55.0,0,0.0
MAZDA,MX-5,2003,25,14,56.0,11,44.0,0,0.0
MAZDA,MX-5,2004,14,8,57.1,6,42.9,0,0.0
MAZDA,MX-5,2005,15,10,66.7,5,33.3,0,0.0
MAZDA,MX-5,2006,52,33,63.5,19,36.5,0,0.0
MAZDA,MX-5,2007,111,70,63.1,41,36.9,0,0.0
MAZDA,MX-5,2008,31,17,54.8,14,45.2,0,0.0
MAZDA,MX-5,2009,3,3,100.0,0,0.0,0,0.0
MAZDA,MX-5,2010,20,14,70.0,6,30.0,0,0.0
MAZDA,MX-5,2011,1,1,100.0,0,0.0,0,0.0
MAZDA,MX-5,2012,4,3,75.0,1,25.0,0,0.0
MAZDA,MX-5,2013,1,1,100.0,0,0.0,0,0.0
MAZDA,MX-5,2014,3,3,100.0,0,0.0,0,0.0
MAZDA,MX-6,1993,1,0,0.0,1,100.0,0,0.0
MAZDA,MX-6,2002,10,5,50.0,5,50.0,0,0.0
MAZDA,MX-6,2003,17,5,29.4,12,70.6,0,0.0
MAZDA,MX-6,2004,11,5,45.5,6,54.5,0,0.0
MAZDA,MX-6,2005,1,1,100.0,0,0.0,0,0.0
MAZDA,OTHER,1981,1,0,0.0,1,100.0,0,0.0
MAZDA,OTHER,1989,2,2,100.0,0,0.0,0,0.0
MAZDA,OTHER,1990,56,27,48.2,29,51.8,1,1.8
MAZDA,OTHER,1991,82,42,51.2,40,48.8,0,0.0
MAZDA,OTHER,1992,83,36,43.4,47,56.6,0,0.0
MAZDA,OTHER,1993,77,32,41.6,45,58.4,0,0.0
MAZDA,OTHER,1994,41,14,34.1,27,65.9,0,0.0
MAZDA,OTHER,1995,24,11,45.8,13,54.2,0,0.0
MAZDA,OTHER,1996,9,2,22.2,7,77.8,0,0.0
MAZDA,OTHER,1997,13,5,38.5,8,61.5,0,0.0
MAZDA,OTHER,1998,71,24,33.8,47,66.2,0,0.0
MAZDA,OTHER,1999,31,11,35.5,20,64.5,0,0.0
MAZDA,OTHER,2000,21,9,42.9,12,57.1,0,0.0
MAZDA,OTHER,2001,27,11,40.7,16,59.3,0,0.0
MAZDA,OTHER,2002,14,5,35.7,9,64.3,0,0.0
MAZDA,OTHER,2003,138,54,39.1,84,60.9,0,0.0
MAZDA,OTHER,2004,447,178,39.8,269,60.2,0,0.0
MAZDA,OTHER,2005,526,215,40.9,311,59.1,0,0.0
MAZDA,OTHER,2006,224,90,40.2,134,59.8,0,0.0
MAZDA,OTHER,2007,332,153,46.1,179,53.9,0,0.0
MAZDA,OTHER,2008,44,15,34.1,29,65.9,0,0.0
MAZDA,OTHER,2009,1,1,100.0,0,0.0,0,0.0
MAZDA,OTHER,2010,1,1,100.0,0,0.0,0,0.0
MAZDA,PREMACY,1999,1,0,0.0,1,100.0,0,0.0
MAZDA,PREMACY,2000,3,1,33.3,2,66.7,0,0.0
MAZDA,PREMACY,2001,3,0,0.0,3,100.0,0,0.0
MAZDA,PREMACY,2002,15,4,26.7,11,73.3,0,0.0
MAZDA,PREMACY,2003,15,5,33.3,10,66.7,0,0.0
MAZDA,PREMACY,2004,14,4,28.6,10,71.4,0,0.0
MAZDA,PREMACY,2005,3,1,33.3,2,66.7,0,0.0
MAZDA,PREMACY,2006,1,0,0.0,1,100.0,0,0.0
MAZDA,PREMACY,2007,2,1,50.0,1,50.0,0,0.0
MAZDA,PREMACY,2008,4,2,50.0,2,50.0,0,0.0
MAZDA,PREMACY,2009,3,2,66.7,1,33.3,0,0.0
MAZDA,PREMACY,2010,2,1,50.0,1,50.0,0,0.0
MAZDA,PREMACY,2011,2,1,50.0,1,50.0,0,0.0
MAZDA,PREMACY,2013,1,1,100.0,0,0.0,0,0.0
MAZDA,RX7,1984,2,1,50.0,1,50.0,0,0.0
MAZDA,RX7,1997,2,2,100.0,0,0.0,0,0.0
MAZDA,RX7,1999,1,0,0.0,1,100.0,0,0.0
MAZDA,RX7,2002,1,1,100.0,0,0.0,0,0.0
MAZDA,RX8,2003,22,8,36.4,14,63.6,0,0.0
MAZDA,RX8,2004,84,35,41.7,49,58.3,0,0.0
MAZDA,RX8,2005,37,13,35.1,24,64.9,0,0.0
MAZDA,RX8,2006,51,30,58.8,21,41.2,0,0.0
MAZDA,RX8,2007,51,21,41.2,30,58.8,0,0.0
MAZDA,RX8,2008,16,6,37.5,10,62.5,0,0.0
MAZDA,RX8,2009,1,1,100.0,0,0.0,0,0.0
MAZDA,TRIBUTE,2000,1,0,0.0,1,100.0,0,0.0
MAZDA,TRIBUTE,2001,8,3,37.5,5,62.5,0,0.0
MAZDA,TRIBUTE,2002,9,6,66.7,3,33.3,0,0.0
MAZDA,TRIBUTE,2003,9,4,44.4,5,55.6,0,0.0
MAZDA,TRIBUTE,2004,19,8,42.1,11,57.9,0,0.0
MAZDA,TRIBUTE,2005,11,4,36.4,7,63.6,0,0.0
MAZDA,XEDOS,1996,1,1,100.0,0,0.0,0,0.0
MAZDA,XEDOS,1997,1,1,100.0,0,0.0,0,0.0
MAZDA,XEDOS,1998,6,5,83.3,1,16.7,0,0.0
MAZDA,XEDOS,1999,2,1,50.0,1,50.0,0,0.0
MAZDA,XEDOS,2000,1,0,0.0,1,100.0,0,0.0
MAZDA,XEDOS,2001,3,3,100.0,0,0.0,0,0.0
MAZDA,XEDOS,2004,2,0,0.0,2,100.0,0,0.0
MERCEDES BENZ,120 VITO CDI KA/E 5DR A,2003,1,1,100.0,0,0.0,0,0.0
MERCEDES BENZ,120 VITO CDI KA/E 5DR A,2004,1,1,100.0,0,0.0,0,0.0
MERCEDES BENZ,1858,2015,1,1,100.0,0,0.0,0,0.0
MERCEDES BENZ,300 SL,1987,1,1,100.0,0,0.0,0,0.0
MERCEDES BENZ,500,2006,2,1,50.0,1,50.0,0,0.0
MERCEDES BENZ,500,2007,3,1,33.3,2,66.7,0,0.0
MERCEDES BENZ,614,2003,4,4,100.0,0,0.0,0,0.0
MERCEDES BENZ,614,2004,2,2,100.0,0,0.0,0,0.0
MERCEDES BENZ,614,2007,1,1,100.0,0,0.0,0,0.0
MERCEDES BENZ,614,2008,1,1,100.0,0,0.0,0,0.0
MERCEDES BENZ,614,2012,1,0,0.0,1,100.0,0,0.0
MERCEDES BENZ,614,2013,1,1,100.0,0,0.0,0,0.0
MERCEDES BENZ,614,2014,23,15,65.2,8,34.8,0,0.0
MERCEDES BENZ,A SERIES,2000,4,1,25.0,3,75.0,0,0.0
MERCEDES BENZ,A SERIES,2001,7,0,0.0,7,100.0,0,0.0
MERCEDES BENZ,A SERIES,2002,9,3,33.3,6,66.7,0,0.0
MERCEDES BENZ,A SERIES,2003,23,8,34.8,15,65.2,0,0.0
MERCEDES BENZ,A SERIES,2004,19,9,47.4,10,52.6,0,0.0
MERCEDES BENZ,A SERIES,2005,14,8,57.1,6,42.9,0,0.0
MERCEDES BENZ,A SERIES,2006,26,13,50.0,13,50.0,0,0.0
MERCEDES BENZ,A SERIES,2007,21,7,33.3,14,66.7,0,0.0
MERCEDES BENZ,A SERIES,2008,49,18,36.7,31,63.3,0,0.0
MERCEDES BENZ,A SERIES,2009,36,17,47.2,19,52.8,0,0.0
MERCEDES BENZ,A SERIES,2010,42,25,59.5,17,40.5,0,0.0
MERCEDES BENZ,A SERIES,2011,16,9,56.3,7,43.8,0,0.0
MERCEDES BENZ,A SERIES,2012,30,21,70.0,9,30.0,0,0.0
MERCEDES BENZ,A SERIES,2013,61,47,77.0,14,23.0,0,0.0
MERCEDES BENZ,A SERIES,2014,277,236,85.2,41,14.8,0,0.0
MERCEDES BENZ,A SERIES,2015,21,20,95.2,1,4.8,0,0.0
MERCEDES BENZ,A SERIES,2016,1,1,100.0,0,0.0,0,0.0
MERCEDES BENZ,A V280,2002,2,0,0.0,2,100.0,0,0.0
MERCEDES BENZ,AMG,2016,1,1,100.0,0,0.0,0,0.0
MERCEDES BENZ,B SERIES,2005,9,3,33.3,6,66.7,0,0.0
MERCEDES BENZ,B SERIES,2006,424,217,51.2,207,48.8,0,0.0
MERCEDES BENZ,B SERIES,2007,430,226,52.6,204,47.4,0,0.0
MERCEDES BENZ,B SERIES,2008,124,61,49.2,63,50.8,0,0.0
MERCEDES BENZ,B SERIES,2009,54,26,48.1,28,51.9,0,0.0
MERCEDES BENZ,B SERIES,2010,56,33,58.9,23,41.1,0,0.0
MERCEDES BENZ,B SERIES,2011,15,8,53.3,7,46.7,0,0.0
MERCEDES BENZ,B SERIES,2012,146,111,76.0,35,24.0,0,0.0
MERCEDES BENZ,B SERIES,2013,34,30,88.2,4,11.8,0,0.0
MERCEDES BENZ,B SERIES,2014,166,146,88.0,20,12.0,0,0.0
MERCEDES BENZ,B SERIES,2015,17,16,94.1,1,5.9,0,0.0
MERCEDES BENZ,C 320 AVANTGARDE 5DR A,2008,1,0,0.0,1,100.0,0,0.0
MERCEDES BENZ,C SERIES,1988,1,0,0.0,1,100.0,0,0.0
MERCEDES BENZ,C SERIES,1994,3,1,33.3,2,66.7,0,0.0
MERCEDES BENZ,C SERIES,1995,3,2,66.7,1,33.3,0,0.0
MERCEDES BENZ,C SERIES,1996,3,2,66.7,1,33.3,0,0.0
MERCEDES BENZ,C SERIES,1997,23,10,43.5,13,56.5,0,0.0
MERCEDES BENZ,C SERIES,1998,12,6,50.0,6,50.0,0,0.0
MERCEDES BENZ,C SERIES,1999,13,2,15.4,11,84.6,0,0.0
MERCEDES BENZ,C SERIES,2000,20,8,40.0,12,60.0,0,0.0
MERCEDES BENZ,C SERIES,2001,30,8,26.7,22,73.3,0,0.0
MERCEDES BENZ,C SERIES,2002,90,21,23.3,69,76.7,0,0.0
MERCEDES BENZ,C SERIES,2003,194,66,34.0,128,66.0,0,0.0
MERCEDES BENZ,C SERIES,2004,299,101,33.8,198,66.2,0,0.0
MERCEDES BENZ,C SERIES,2005,492,181,36.8,311,63.2,0,0.0
MERCEDES BENZ,C SERIES,2006,475,203,42.7,272,57.3,0,0.0
MERCEDES BENZ,C SERIES,2007,511,224,43.8,287,56.2,0,0.0
MERCEDES BENZ,C SERIES,2008,527,237,45.0,290,55.0,0,0.0
MERCEDES BENZ,C SERIES,2009,357,187,52.4,170,47.6,0,0.0
MERCEDES BENZ,C SERIES,2010,828,467,56.4,361,43.6,0,0.0
MERCEDES BENZ,C SERIES,2011,273,167,61.2,106,38.8,0,0.0
MERCEDES BENZ,C SERIES,2012,919,662,72.0,257,28.0,0,0.0
MERCEDES BENZ,C SERIES,2013,274,209,76.3,65,23.7,0,0.0
MERCEDES BENZ,C SERIES,2014,616,477,77.4,139,22.6,0,0.0
MERCEDES BENZ,C SERIES,2015,74,59,79.7,15,20.3,0,0.0
MERCEDES BENZ,C SERIES,2016,2,0,0.0,2,100.0,0,0.0
MERCEDES BENZ,C SERIES,2017,1,1,100.0,0,0.0,0,0.0
MERCEDES BENZ,C180,1994,10,3,30.0,7,70.0,0,0.0
MERCEDES BENZ,C180,1995,11,4,36.4,7,63.6,0,0.0
MERCEDES BENZ,C180,1996,13,8,61.5,5,38.5,0,0.0
MERCEDES BENZ,C180,1997,24,9,37.5,15,62.5,0,0.0
MERCEDES BENZ,C180,1998,56,25,44.6,31,55.4,0,0.0
MERCEDES BENZ,C180,1999,67,24,35.8,43,64.2,0,0.0
MERCEDES BENZ,C180,2000,23,8,34.8,15,65.2,0,0.0
MERCEDES BENZ,C180,2001,163,66,40.5,97,59.5,0,0.0
MERCEDES BENZ,C180,2002,251,101,40.2,150,59.8,0,0.0
MERCEDES BENZ,C180,2003,31,10,32.3,21,67.7,0,0.0
MERCEDES BENZ,C180,2004,76,32,42.1,44,57.9,0,0.0
MERCEDES BENZ,C180,2005,459,215,46.8,244,53.2,0,0.0
MERCEDES BENZ,C180,2006,632,294,46.5,338,53.5,0,0.0
MERCEDES BENZ,C180,2007,538,259,48.1,279,51.9,0,0.0
MERCEDES BENZ,C180,2008,370,210,56.8,160,43.2,0,0.0
MERCEDES BENZ,C180,2010,4,2,50.0,2,50.0,0,0.0
MERCEDES BENZ,C180,2012,14,12,85.7,2,14.3,0,0.0
MERCEDES BENZ,C180,2014,13,10,76.9,3,23.1,0,0.0
MERCEDES BENZ,C180,2015,7,6,85.7,1,14.3,0,0.0
MERCEDES BENZ,C180 ELEGANCE,2001,1,1,100.0,0,0.0,0,0.0
MERCEDES BENZ,C200 KOMP 1.8 AVANTGARDE 4DR A,2008,1,1,100.0,0,0.0,0,0.0
MERCEDES BENZ,C200 KOMP 1.8 ELEGANCE 4DR A,2007,1,1,100.0,0,0.0,0,0.0
MERCEDES BENZ,C200 KOMPRESSOR,2001,2,1,50.0,1,50.0,0,0.0
MERCEDES BENZ,C200 KOMPRESSOR,2002,2,1,50.0,1,50.0,0,0.0
MERCEDES BENZ,C200 KOMPRESSOR,2003,9,1,11.1,8,88.9,0,0.0
MERCEDES BENZ,C200 KOMPRESSOR,2004,5,1,20.0,4,80.0,0,0.0
MERCEDES BENZ,C200 KOMPRESSOR,2005,8,5,62.5,3,37.5,0,0.0
MERCEDES BENZ,C200 KOMPRESSOR,2006,3,1,33.3,2,66.7,0,0.0
MERCEDES BENZ,C200 KOMPRESSOR,2007,6,4,66.7,2,33.3,0,0.0
MERCEDES BENZ,C220,1995,2,0,0.0,2,100.0,0,0.0
MERCEDES BENZ,C220,1996,7,2,28.6,5,71.4,0,0.0
MERCEDES BENZ,C220,1997,1,1,100.0,0,0.0,0,0.0
MERCEDES BENZ,C220,1998,4,1,25.0,3,75.0,0,0.0
MERCEDES BENZ,C220,1999,2,2,100.0,0,0.0,0,0.0
MERCEDES BENZ,C220,2000,15,5,33.3,10,66.7,0,0.0
MERCEDES BENZ,C220,2001,25,7,28.0,18,72.0,0,0.0
MERCEDES BENZ,C220,2002,35,17,48.6,18,51.4,0,0.0
MERCEDES BENZ,C220,2003,37,10,27.0,27,73.0,0,0.0
MERCEDES BENZ,C220,2004,32,12,37.5,20,62.5,0,0.0
MERCEDES BENZ,C220,2005,57,18,31.6,39,68.4,0,0.0
MERCEDES BENZ,C220,2006,25,11,44.0,14,56.0,0,0.0
MERCEDES BENZ,C220,2007,86,46,53.5,40,46.5,0,0.0
MERCEDES BENZ,C220,2008,39,15,38.5,24,61.5,0,0.0
MERCEDES BENZ,C220,2012,89,69,77.5,20,22.5,0,0.0
MERCEDES BENZ,C220,2013,8,7,87.5,1,12.5,0,0.0
MERCEDES BENZ,C220,2014,122,98,80.3,24,19.7,0,0.0
MERCEDES BENZ,C220,2015,16,13,81.3,3,18.8,0,0.0
MERCEDES BENZ,CL,2007,1,1,100.0,0,0.0,0,0.0
MERCEDES BENZ,CL,2010,2,0,0.0,2,100.0,0,0.0
MERCEDES BENZ,CL 55 AMG 2DR AUTOMATIC,2002,1,0,0.0,1,100.0,0,0.0
MERCEDES BENZ,CL500,1997,1,1,100.0,0,0.0,0,0.0
MERCEDES BENZ,CL500,2000,2,1,50.0,1,50.0,0,0.0
MERCEDES BENZ,CL500,2001,1,1,100.0,0,0.0,0,0.0
MERCEDES BENZ,CL500,2002,3,1,33.3,2,66.7,0,0.0
MERCEDES BENZ,CL500,2003,2,1,50.0,1,50.0,0,0.0
MERCEDES BENZ,CL500,2004,2,0,0.0,2,100.0,0,0.0
MERCEDES BENZ,CL500,2005,4,4,100.0,0,0.0,0,0.0
MERCEDES BENZ,CL500,2006,1,0,0.0,1,100.0,0,0.0
MERCEDES BENZ,CL500,2007,40,27,67.5,13,32.5,0,0.0
MERCEDES BENZ,CL500,2008,24,17,70.8,7,29.2,0,0.0
MERCEDES BENZ,CL500,2009,1,0,0.0,1,100.0,0,0.0
MERCEDES BENZ,CL500,2010,1,1,100.0,0,0.0,0,0.0
MERCEDES BENZ,CL500,2012,2,1,50.0,1,50.0,0,0.0
MERCEDES BENZ,CL500,2014,1,1,100.0,0,0.0,0,0.0
MERCEDES BENZ,CLA,2013,4,2,50.0,2,50.0,0,0.0
MERCEDES BENZ,CLA,2014,302,256,84.8,46,15.2,0,0.0
MERCEDES BENZ,CLA,2015,40,34,85.0,6,15.0,0,0.0
MERCEDES BENZ,CLC SERIES,2008,5,0,0.0,5,100.0,0,0.0
MERCEDES BENZ,CLC SERIES,2009,8,4,50.0,4,50.0,0,0.0
MERCEDES BENZ,CLC SERIES,2010,8,5,62.5,3,37.5,0,0.0
MERCEDES BENZ,CLK 200 KOMP AVANTGARDE 2DR A,2004,1,1,100.0,0,0.0,0,0.0
MERCEDES BENZ,CLK 200 KOMP AVANTGARDE 2DR A,2007,1,0,0.0,1,100.0,0,0.0
MERCEDES BENZ,CLK 280 AVANTGARDE 2DR A,2007,1,1,100.0,0,0.0,0,0.0
MERCEDES BENZ,CLK SERIES,1997,2,0,0.0,2,100.0,0,0.0
MERCEDES BENZ,CLK SERIES,1998,6,2,33.3,4,66.7,0,0.0
MERCEDES BENZ,CLK SERIES,1999,8,4,50.0,4,50.0,0,0.0
MERCEDES BENZ,CLK SERIES,2000,16,6,37.5,10,62.5,0,0.0
MERCEDES BENZ,CLK SERIES,2001,16,3,18.8,13,81.3,0,0.0
MERCEDES BENZ,CLK SERIES,2002,18,8,44.4,10,55.6,0,0.0
MERCEDES BENZ,CLK SERIES,2003,39,9,23.1,30,76.9,0,0.0
MERCEDES BENZ,CLK SERIES,2004,29,7,24.1,22,75.9,0,0.0
MERCEDES BENZ,CLK SERIES,2005,151,74,49.0,77,51.0,0,0.0
MERCEDES BENZ,CLK SERIES,2006,382,205,53.7,177,46.3,0,0.0
MERCEDES BENZ,CLK SERIES,2007,285,130,45.6,155,54.4,0,0.0
MERCEDES BENZ,CLK SERIES,2008,93,42,45.2,51,54.8,0,0.0
MERCEDES BENZ,CLK SERIES,2009,14,6,42.9,8,57.1,0,0.0
MERCEDES BENZ,CLK SERIES,2010,22,13,59.1,9,40.9,0,0.0
MERCEDES BENZ,CLK SERIES,2011,1,0,0.0,1,100.0,0,0.0
MERCEDES BENZ,CLS,2005,9,5,55.6,4,44.4,0,0.0
MERCEDES BENZ,CLS,2006,176,71,40.3,105,59.7,0,0.0
MERCEDES BENZ,CLS,2007,128,50,39.1,78,60.9,0,0.0
MERCEDES BENZ,CLS,2008,43,11,25.6,32,74.4,0,0.0
MERCEDES BENZ,CLS,2009,16,8,50.0,8,50.0,0,0.0
MERCEDES BENZ,CLS,2010,17,7,41.2,10,58.8,0,0.0
MERCEDES BENZ,CLS,2011,10,5,50.0,5,50.0,0,0.0
MERCEDES BENZ,CLS,2012,78,54,69.2,24,30.8,0,0.0
MERCEDES BENZ,CLS,2013,45,28,62.2,17,37.8,0,0.0
MERCEDES BENZ,CLS,2014,105,85,81.0,20,19.0,0,0.0
MERCEDES BENZ,CLS,2015,9,5,55.6,4,44.4,0,0.0
MERCEDES BENZ,CLS,2017,1,1,100.0,0,0.0,0,0.0
MERCEDES BENZ,CLS55 AMG,2005,7,4,57.1,3,42.9,0,0.0
MERCEDES BENZ,CLS55 AMG,2006,3,3,100.0,0,0.0,0,0.0
MERCEDES BENZ,E 220 CDI,2002,4,2,50.0,2,50.0,0,0.0
MERCEDES BENZ,E 220 CDI,2003,1,0,0.0,1,100.0,0,0.0
MERCEDES BENZ,E 220 CDI,2004,4,1,25.0,3,75.0,0,0.0
MERCEDES BENZ,E 220 CDI,2005,7,3,42.9,4,57.1,0,0.0
MERCEDES BENZ,E 220 CDI,2006,6,2,33.3,4,66.7,0,0.0
MERCEDES BENZ,E 220 CDI,2007,2,0,0.0,2,100.0,0,0.0
MERCEDES BENZ,E 220 CDI,2008,12,7,58.3,5,41.7,0,0.0
MERCEDES BENZ,E 220 CDI,2009,3,1,33.3,2,66.7,0,0.0
MERCEDES BENZ,E 220 CDI,2010,29,14,48.3,15,51.7,0,0.0
MERCEDES BENZ,E 220 CDI,2011,18,13,72.2,5,27.8,0,0.0
MERCEDES BENZ,E 220 CDI,2012,119,81,68.1,38,31.9,0,0.0
MERCEDES BENZ,E 220 CDI,2013,47,30,63.8,17,36.2,0,0.0
MERCEDES BENZ,E 220 CDI,2014,160,133,83.1,27,16.9,0,0.0
MERCEDES BENZ,E 220 CDI,2015,9,9,100.0,0,0.0,0,0.0
MERCEDES BENZ,E 220 CDI,2016,4,3,75.0,1,25.0,0,0.0
MERCEDES BENZ,E 220 CDI CLASSIC 04DR A,2003,1,0,0.0,1,100.0,0,0.0
MERCEDES BENZ,E 220 CDI CLASSIC 04DR A,2005,1,0,0.0,1,100.0,0,0.0
MERCEDES BENZ,E SERIES,1986,2,1,50.0,1,50.0,0,0.0
MERCEDES BENZ,E SERIES,1993,3,1,33.3,2,66.7,0,0.0
MERCEDES BENZ,E SERIES,1994,23,13,56.5,10,43.5,0,0.0
MERCEDES BENZ,E SERIES,1995,13,6,46.2,7,53.8,0,0.0
MERCEDES BENZ,E SERIES,1996,9,6,66.7,3,33.3,0,0.0
MERCEDES BENZ,E SERIES,1997,2,1,50.0,1,50.0,0,0.0
MERCEDES BENZ,E SERIES,1998,5,1,20.0,4,80.0,0,0.0
MERCEDES BENZ,E SERIES,1999,8,2,25.0,6,75.0,0,0.0
MERCEDES BENZ,E SERIES,2000,7,3,42.9,4,57.1,0,0.0
MERCEDES BENZ,E SERIES,2001,32,10,31.3,22,68.8,0,0.0
MERCEDES BENZ,E SERIES,2002,40,18,45.0,22,55.0,0,0.0
MERCEDES BENZ,E SERIES,2003,75,29,38.7,46,61.3,0,0.0
MERCEDES BENZ,E SERIES,2004,123,53,43.1,70,56.9,0,0.0
MERCEDES BENZ,E SERIES,2005,171,66,38.6,105,61.4,0,0.0
MERCEDES BENZ,E SERIES,2006,404,149,36.9,255,63.1,0,0.0
MERCEDES BENZ,E SERIES,2007,596,249,41.8,347,58.2,0,0.0
MERCEDES BENZ,E SERIES,2008,343,118,34.4,225,65.6,0,0.0
MERCEDES BENZ,E SERIES,2009,199,80,40.2,119,59.8,0,0.0
MERCEDES BENZ,E SERIES,2010,1535,956,62.3,579,37.7,0,0.0
MERCEDES BENZ,E SERIES,2011,398,273,68.6,125,31.4,0,0.0
MERCEDES BENZ,E SERIES,2012,1383,1041,75.3,342,24.7,1,0.1
MERCEDES BENZ,E SERIES,2013,424,329,77.6,95,22.4,3,0.7
MERCEDES BENZ,E SERIES,2014,1523,1246,81.8,277,18.2,8,0.5
MERCEDES BENZ,E SERIES,2015,227,189,83.3,38,16.7,0,0.0
MERCEDES BENZ,E SERIES,2016,72,59,81.9,13,18.1,0,0.0
MERCEDES BENZ,E SERIES,2017,38,35,92.1,3,7.9,0,0.0
MERCEDES BENZ,E SERIES,2018,11,7,63.6,4,36.4,2,18.2
MERCEDES BENZ,E200,1990,1,1,100.0,0,0.0,0,0.0
MERCEDES BENZ,E200,1995,1,0,0.0,1,100.0,0,0.0
MERCEDES BENZ,E200,2002,1,0,0.0,1,100.0,0,0.0
MERCEDES BENZ,E200,2003,1,0,0.0,1,100.0,0,0.0
MERCEDES BENZ,E200,2005,47,18,38.3,29,61.7,0,0.0
MERCEDES BENZ,E200,2006,702,355,50.6,347,49.4,0,0.0
MERCEDES BENZ,E200,2007,783,385,49.2,398,50.8,0,0.0
MERCEDES BENZ,E200,2008,353,167,47.3,186,52.7,1,0.3
MERCEDES BENZ,E200,2009,23,15,65.2,8,34.8,0,0.0
MERCEDES BENZ,E200,2014,1,0,0.0,1,100.0,0,0.0
MERCEDES BENZ,E200 KOMP AVANGARDE AUTOMATIC,2006,2,0,0.0,2,100.0,0,0.0
MERCEDES BENZ,E200 KOMPRESSOR,2000,20,8,40.0,12,60.0,0,0.0
MERCEDES BENZ,E200 KOMPRESSOR,2001,134,54,40.3,80,59.7,0,0.0
MERCEDES BENZ,E200 KOMPRESSOR,2002,116,42,36.2,74,63.8,1,0.9
MERCEDES BENZ,E200 KOMPRESSOR,2003,1,1,100.0,0,0.0,0,0.0
MERCEDES BENZ,E200 KOMPRESSOR,2005,2,1,50.0,1,50.0,0,0.0
MERCEDES BENZ,E220 CDI AVANTGARDE 4DR,2005,2,0,0.0,2,100.0,0,0.0
MERCEDES BENZ,E220 CDI AVANTGARDE 4DR,2008,1,1,100.0,0,0.0,0,0.0
MERCEDES BENZ,E220 CDI AVANTGARDE 4DR,2009,1,0,0.0,1,100.0,0,0.0
MERCEDES BENZ,E220 CDI ELEGANCE,2003,1,0,0.0,1,100.0,0,0.0
MERCEDES BENZ,E220 CDI ELEGANCE,2008,19,6,31.6,13,68.4,0,0.0
MERCEDES BENZ,E220 CDI ELEGANCE,2009,67,23,34.3,44,65.7,0,0.0
MERCEDES BENZ,E280,1994,1,0,0.0,1,100.0,0,0.0
MERCEDES BENZ,E280,1995,1,0,0.0,1,100.0,0,0.0
MERCEDES BENZ,E280,2000,2,1,50.0,1,50.0,0,0.0
MERCEDES BENZ,E280,2005,22,9,40.9,13,59.1,0,0.0
MERCEDES BENZ,E280,2006,155,79,51.0,76,49.0,0,0.0
MERCEDES BENZ,E280,2007,168,73,43.5,95,56.5,0,0.0
MERCEDES BENZ,E280,2008,50,18,36.0,32,64.0,0,0.0
MERCEDES BENZ,E280,2009,6,4,66.7,2,33.3,0,0.0
MERCEDES BENZ,E280,2010,4,2,50.0,2,50.0,0,0.0
MERCEDES BENZ,G SERIES,1983,2,1,50.0,1,50.0,0,0.0
MERCEDES BENZ,G SERIES,1985,1,0,0.0,1,100.0,0,0.0
MERCEDES BENZ,G SERIES,1986,1,1,100.0,0,0.0,0,0.0
MERCEDES BENZ,G SERIES,1989,2,0,0.0,2,100.0,0,0.0
MERCEDES BENZ,G SERIES,1991,1,1,100.0,0,0.0,0,0.0
MERCEDES BENZ,G SERIES,1992,1,0,0.0,1,100.0,0,0.0
MERCEDES BENZ,G SERIES,1993,1,1,100.0,0,0.0,0,0.0
MERCEDES BENZ,G SERIES,1994,2,2,100.0,0,0.0,0,0.0
MERCEDES BENZ,G SERIES,1997,1,1,100.0,0,0.0,0,0.0
MERCEDES BENZ,G SERIES,2005,1,0,0.0,1,100.0,0,0.0
MERCEDES BENZ,G SERIES,2006,1,0,0.0,1,100.0,0,0.0
MERCEDES BENZ,G SERIES,2011,1,1,100.0,0,0.0,0,0.0
MERCEDES BENZ,G SERIES,2013,2,1,50.0,1,50.0,0,0.0
MERCEDES BENZ,GL,2006,1,0,0.0,1,100.0,0,0.0
MERCEDES BENZ,GL,2007,6,3,50.0,3,50.0,0,0.0
MERCEDES BENZ,GL,2009,1,0,0.0,1,100.0,0,0.0
MERCEDES BENZ,GL,2010,8,4,50.0,4,50.0,0,0.0
MERCEDES BENZ,GL,2011,1,0,0.0,1,100.0,0,0.0
MERCEDES BENZ,GL,2012,1,1,100.0,0,0.0,0,0.0
MERCEDES BENZ,GL,2013,5,0,0.0,5,100.0,0,0.0
MERCEDES BENZ,GL,2014,6,6,100.0,0,0.0,0,0.0
MERCEDES BENZ,GL,2015,1,0,0.0,1,100.0,0,0.0
MERCEDES BENZ,GLA,2014,83,74,89.2,9,10.8,0,0.0
MERCEDES BENZ,GLA,2015,12,11,91.7,1,8.3,0,0.0
MERCEDES BENZ,GLE,2017,2,2,100.0,0,0.0,0,0.0
MERCEDES BENZ,GLE,2018,1,1,100.0,0,0.0,0,0.0
MERCEDES BENZ,KOMPRESSOR 1.8 ELEGANCE 4DR,2005,2,0,0.0,2,100.0,0,0.0
MERCEDES BENZ,MAYBACH,2004,2,0,0.0,2,100.0,0,0.0
MERCEDES BENZ,ML,2000,1,0,0.0,1,100.0,0,0.0
MERCEDES BENZ,ML,2001,1,1,100.0,0,0.0,0,0.0
MERCEDES BENZ,ML,2002,2,0,0.0,2,100.0,0,0.0
MERCEDES BENZ,ML,2003,3,1,33.3,2,66.7,0,0.0
MERCEDES BENZ,ML,2004,1,1,100.0,0,0.0,0,0.0
MERCEDES BENZ,ML,2005,4,1,25.0,3,75.0,0,0.0
MERCEDES BENZ,ML,2006,6,1,16.7,5,83.3,0,0.0
MERCEDES BENZ,ML,2007,7,5,71.4,2,28.6,0,0.0
MERCEDES BENZ,ML,2008,2,2,100.0,0,0.0,0,0.0
MERCEDES BENZ,ML,2009,2,0,0.0,2,100.0,0,0.0
MERCEDES BENZ,ML,2010,4,2,50.0,2,50.0,0,0.0
MERCEDES BENZ,ML,2011,2,1,50.0,1,50.0,0,0.0
MERCEDES BENZ,ML,2012,56,37,66.1,19,33.9,0,0.0
MERCEDES BENZ,ML,2013,16,9,56.3,7,43.8,1,6.3
MERCEDES BENZ,ML,2014,37,24,64.9,13,35.1,0,0.0
MERCEDES BENZ,ML,2015,4,4,100.0,0,0.0,0,0.0
MERCEDES BENZ,ML 270,2005,1,0,0.0,1,100.0,0,0.0
MERCEDES BENZ,ML 320 CDI 4DR A,2007,1,0,0.0,1,100.0,0,0.0
MERCEDES BENZ,ML 320 CDI 5DR A,2006,1,1,100.0,0,0.0,0,0.0
MERCEDES BENZ,OTHER,1974,1,0,0.0,1,100.0,0,0.0
MERCEDES BENZ,OTHER,1978,1,0,0.0,1,100.0,0,0.0
MERCEDES BENZ,OTHER,1979,1,1,100.0,0,0.0,0,0.0
MERCEDES BENZ,OTHER,1980,13,5,38.5,8,61.5,0,0.0
MERCEDES BENZ,OTHER,1981,23,7,30.4,16,69.6,0,0.0
MERCEDES BENZ,OTHER,1982,34,11,32.4,23,67.6,0,0.0
MERCEDES BENZ,OTHER,1983,50,22,44.0,28,56.0,0,0.0
MERCEDES BENZ,OTHER,1984,65,34,52.3,31,47.7,0,0.0
MERCEDES BENZ,OTHER,1985,41,22,53.7,19,46.3,0,0.0
MERCEDES BENZ,OTHER,1986,65,26,40.0,39,60.0,0,0.0
MERCEDES BENZ,OTHER,1987,59,22,37.3,37,62.7,1,1.7
MERCEDES BENZ,OTHER,1988,82,33,40.2,49,59.8,0,0.0
MERCEDES BENZ,OTHER,1989,45,16,35.6,29,64.4,0,0.0
MERCEDES BENZ,OTHER,1990,89,36,40.4,53,59.6,0,0.0
MERCEDES BENZ,OTHER,1991,97,42,43.3,55,56.7,0,0.0
MERCEDES BENZ,OTHER,1992,86,43,50.0,43,50.0,0,0.0
MERCEDES BENZ,OTHER,1993,93,45,48.4,48,51.6,0,0.0
MERCEDES BENZ,OTHER,1994,119,46,38.7,73,61.3,0,0.0
MERCEDES BENZ,OTHER,1995,133,51,38.3,82,61.7,0,0.0
MERCEDES BENZ,OTHER,1996,129,47,36.4,82,63.6,0,0.0
MERCEDES BENZ,OTHER,1997,133,47,35.3,86,64.7,0,0.0
MERCEDES BENZ,OTHER,1998,249,97,39.0,152,61.0,0,0.0
MERCEDES BENZ,OTHER,1999,364,149,40.9,215,59.1,0,0.0
MERCEDES BENZ,OTHER,2000,628,267,42.5,361,57.5,0,0.0
MERCEDES BENZ,OTHER,2001,644,248,38.5,396,61.5,1,0.2
MERCEDES BENZ,OTHER,2002,748,288,38.5,460,61.5,0,0.0
MERCEDES BENZ,OTHER,2003,2296,905,39.4,1391,60.6,1,0.0
MERCEDES BENZ,OTHER,2004,3138,1341,42.7,1797,57.3,1,0.0
MERCEDES BENZ,OTHER,2005,3059,1336,43.7,1723,56.3,0,0.0
MERCEDES BENZ,OTHER,2006,1350,639,47.3,711,52.7,0,0.0
MERCEDES BENZ,OTHER,2007,974,480,49.3,494,50.7,1,0.1
MERCEDES BENZ,OTHER,2008,429,210,49.0,219,51.0,1,0.2
MERCEDES BENZ,OTHER,2009,40,22,55.0,18,45.0,0,0.0
MERCEDES BENZ,OTHER,2010,50,27,54.0,23,46.0,0,0.0
MERCEDES BENZ,OTHER,2011,7,5,71.4,2,28.6,0,0.0
MERCEDES BENZ,OTHER,2012,9,6,66.7,3,33.3,0,0.0
MERCEDES BENZ,OTHER,2013,1,1,100.0,0,0.0,0,0.0
MERCEDES BENZ,OTHER,2014,17,16,94.1,1,5.9,0,0.0
MERCEDES BENZ,OTHER,2015,3,2,66.7,1,33.3,0,0.0
MERCEDES BENZ,OTHER,2016,4,3,75.0,1,25.0,0,0.0
MERCEDES BENZ,OTHER,2017,5,5,100.0,0,0.0,0,0.0
MERCEDES BENZ,R,2006,3,0,0.0,3,100.0,0,0.0
MERCEDES BENZ,R,2007,4,1,25.0,3,75.0,0,0.0
MERCEDES BENZ,R,2008,2,1,50.0,1,50.0,0,0.0
MERCEDES BENZ,R,2010,2,2,100.0,0,0.0,0,0.0
MERCEDES BENZ,R,2011,2,0,0.0,2,100.0,0,0.0
MERCEDES BENZ,R,2012,1,1,100.0,0,0.0,0,0.0
MERCEDES BENZ,S SERIES,1993,2,1,50.0,1,50.0,0,0.0
MERCEDES BENZ,S SERIES,1995,1,1,100.0,0,0.0,0,0.0
MERCEDES BENZ,S SERIES,1996,1,1,100.0,0,0.0,0,0.0
MERCEDES BENZ,S SERIES,1997,1,0,0.0,1,100.0,0,0.0
MERCEDES BENZ,S SERIES,1998,5,1,20.0,4,80.0,0,0.0
MERCEDES BENZ,S SERIES,1999,1,1,100.0,0,0.0,0,0.0
MERCEDES BENZ,S SERIES,2000,3,1,33.3,2,66.7,0,0.0
MERCEDES BENZ,S SERIES,2001,5,3,60.0,2,40.0,0,0.0
MERCEDES BENZ,S SERIES,2002,7,1,14.3,6,85.7,0,0.0
MERCEDES BENZ,S SERIES,2003,13,7,53.8,6,46.2,0,0.0
MERCEDES BENZ,S SERIES,2004,9,1,11.1,8,88.9,0,0.0
MERCEDES BENZ,S SERIES,2005,12,5,41.7,7,58.3,0,0.0
MERCEDES BENZ,S SERIES,2006,26,8,30.8,18,69.2,0,0.0
MERCEDES BENZ,S SERIES,2007,84,41,48.8,43,51.2,0,0.0
MERCEDES BENZ,S SERIES,2008,51,22,43.1,29,56.9,0,0.0
MERCEDES BENZ,S SERIES,2009,19,12,63.2,7,36.8,0,0.0
MERCEDES BENZ,S SERIES,2010,42,22,52.4,20,47.6,0,0.0
MERCEDES BENZ,S SERIES,2011,8,5,62.5,3,37.5,0,0.0
MERCEDES BENZ,S SERIES,2012,25,17,68.0,8,32.0,0,0.0
MERCEDES BENZ,S SERIES,2013,1,1,100.0,0,0.0,0,0.0
MERCEDES BENZ,S SERIES,2014,73,52,71.2,21,28.8,0,0.0
MERCEDES BENZ,S SERIES,2015,15,12,80.0,3,20.0,0,0.0
MERCEDES BENZ,S SERIES,2016,5,4,80.0,1,20.0,0,0.0
MERCEDES BENZ,S SERIES,2017,4,4,100.0,0,0.0,0,0.0
MERCEDES BENZ,S320 CDI LWB 4DR A,2012,1,1,100.0,0,0.0,0,0.0
MERCEDES BENZ,S350,2003,1,1,100.0,0,0.0,0,0.0
MERCEDES BENZ,S350,2004,2,0,0.0,2,100.0,0,0.0
MERCEDES BENZ,S350,2005,1,0,0.0,1,100.0,0,0.0
MERCEDES BENZ,S350,2006,69,37,53.6,32,46.4,0,0.0
MERCEDES BENZ,S350,2007,56,32,57.1,24,42.9,0,0.0
MERCEDES BENZ,S350,2008,17,3,17.6,14,82.4,0,0.0
MERCEDES BENZ,S350,2009,2,2,100.0,0,0.0,0,0.0
MERCEDES BENZ,S350,2010,19,9,47.4,10,52.6,0,0.0
MERCEDES BENZ,S350,2011,13,8,61.5,5,38.5,0,0.0
MERCEDES BENZ,S350,2012,67,42,62.7,25,37.3,0,0.0
MERCEDES BENZ,S350,2013,21,11,52.4,10,47.6,0,0.0
MERCEDES BENZ,S350,2014,72,54,75.0,18,25.0,0,0.0
MERCEDES BENZ,S350,2015,17,12,70.6,5,29.4,0,0.0
MERCEDES BENZ,S350,2016,8,6,75.0,2,25.0,0,0.0
MERCEDES BENZ,S350,2017,13,12,92.3,1,7.7,0,0.0
MERCEDES BENZ,S350,2018,2,2,100.0,0,0.0,0,0.0
MERCEDES BENZ,SI 350,2014,1,1,100.0,0,0.0,0,0.0
MERCEDES BENZ,SL SERIES,1979,1,0,0.0,1,100.0,0,0.0
MERCEDES BENZ,SL SERIES,1982,1,1,100.0,0,0.0,0,0.0
MERCEDES BENZ,SL SERIES,1986,1,1,100.0,0,0.0,0,0.0
MERCEDES BENZ,SL SERIES,1992,1,1,100.0,0,0.0,0,0.0
MERCEDES BENZ,SL SERIES,2003,2,2,100.0,0,0.0,0,0.0
MERCEDES BENZ,SL SERIES,2005,1,0,0.0,1,100.0,0,0.0
MERCEDES BENZ,SL SERIES,2009,1,1,100.0,0,0.0,0,0.0
MERCEDES BENZ,SL SERIES,2010,1,1,100.0,0,0.0,0,0.0
MERCEDES BENZ,SL SERIES,2012,1,1,100.0,0,0.0,0,0.0
MERCEDES BENZ,SL55AMG,2005,1,0,0.0,1,100.0,0,0.0
MERCEDES BENZ,SL63,2012,2,2,100.0,0,0.0,0,0.0
MERCEDES BENZ,SL63,2014,1,1,100.0,0,0.0,0,0.0
MERCEDES BENZ,SLK SERIES,1997,26,13,50.0,13,50.0,0,0.0
MERCEDES BENZ,SLK SERIES,1998,37,14,37.8,23,62.2,0,0.0
MERCEDES BENZ,SLK SERIES,1999,24,16,66.7,8,33.3,0,0.0
MERCEDES BENZ,SLK SERIES,2000,45,26,57.8,19,42.2,0,0.0
MERCEDES BENZ,SLK SERIES,2001,24,10,41.7,14,58.3,0,0.0
MERCEDES BENZ,SLK SERIES,2002,12,6,50.0,6,50.0,0,0.0
MERCEDES BENZ,SLK SERIES,2003,7,3,42.9,4,57.1,0,0.0
MERCEDES BENZ,SLK SERIES,2004,43,19,44.2,24,55.8,0,0.0
MERCEDES BENZ,SLK SERIES,2005,142,80,56.3,62,43.7,0,0.0
MERCEDES BENZ,SLK SERIES,2006,78,59,75.6,19,24.4,0,0.0
MERCEDES BENZ,SLK SERIES,2007,69,35,50.7,34,49.3,0,0.0
MERCEDES BENZ,SLK SERIES,2008,11,8,72.7,3,27.3,0,0.0
MERCEDES BENZ,SLK SERIES,2009,2,1,50.0,1,50.0,0,0.0
MERCEDES BENZ,SLK SERIES,2010,9,8,88.9,1,11.1,0,0.0
MERCEDES BENZ,SLK SERIES,2011,3,3,100.0,0,0.0,0,0.0
MERCEDES BENZ,SLK SERIES,2012,24,18,75.0,6,25.0,0,0.0
MERCEDES BENZ,SLK SERIES,2013,7,5,71.4,2,28.6,0,0.0
MERCEDES BENZ,SLK SERIES,2014,36,31,86.1,5,13.9,0,0.0
MERCEDES BENZ,SLK SERIES,2015,3,2,66.7,1,33.3,0,0.0
MERCEDES BENZ,SLS,2012,1,1,100.0,0,0.0,0,0.0
MERCEDES BENZ,SPRINTER,2010,2,2,100.0,0,0.0,0,0.0
MERCEDES BENZ,SPRINTER,2011,3,2,66.7,1,33.3,0,0.0
MERCEDES BENZ,SPRINTER,2012,2,2,100.0,0,0.0,0,0.0
MERCEDES BENZ,SPRINTER,2013,3,1,33.3,2,66.7,0,0.0
MERCEDES BENZ,SPRINTER,2014,1,0,0.0,1,100.0,0,0.0
MERCEDES BENZ,V SERIES,1999,1,1,100.0,0,0.0,0,0.0
MERCEDES BENZ,V SERIES,2003,1,1,100.0,0,0.0,0,0.0
MERCEDES BENZ,V SERIES,2004,4,0,0.0,4,100.0,0,0.0
MERCEDES BENZ,V SERIES,2005,1,0,0.0,1,100.0,0,0.0
MERCEDES BENZ,V SERIES,2006,10,4,40.0,6,60.0,0,0.0
MERCEDES BENZ,V SERIES,2007,14,6,42.9,8,57.1,0,0.0
MERCEDES BENZ,V SERIES,2008,16,7,43.8,9,56.3,0,0.0
MERCEDES BENZ,V SERIES,2009,6,1,16.7,5,83.3,0,0.0
MERCEDES BENZ,V SERIES,2010,8,3,37.5,5,62.5,0,0.0
MERCEDES BENZ,V SERIES,2011,8,3,37.5,5,62.5,0,0.0
MERCEDES BENZ,V SERIES,2012,17,10,58.8,7,41.2,0,0.0
MERCEDES BENZ,V SERIES,2013,27,20,74.1,7,25.9,0,0.0
MERCEDES BENZ,V SERIES,2014,23,19,82.6,4,17.4,0,0.0
MERCEDES BENZ,V SERIES,2015,21,13,61.9,8,38.1,0,0.0
MERCEDES BENZ,V SERIES,2016,53,39,73.6,14,26.4,0,0.0
MERCEDES BENZ,V SERIES,2017,74,61,82.4,13,17.6,0,0.0
MERCEDES BENZ,V SERIES,2018,3,2,66.7,1,33.3,0,0.0
MERCEDES BENZ,V250,2014,1,0,0.0,1,100.0,0,0.0
MERCEDES BENZ,V250,2015,2,1,50.0,1,50.0,0,0.0
MERCEDES BENZ,V250,2016,3,2,66.7,1,33.3,0,0.0
MERCEDES BENZ,V250,2017,8,6,75.0,2,25.0,0,0.0
MERCEDES BENZ,V250,2018,1,1,100.0,0,0.0,0,0.0
MERCEDES BENZ,VANEO,2002,1,0,0.0,1,100.0,0,0.0
MERCEDES BENZ,VANEO,2003,5,3,60.0,2,40.0,0,0.0
MERCEDES BENZ,VANEO,2004,5,1,20.0,4,80.0,0,0.0
MERCEDES BENZ,VANEO,2005,6,1,16.7,5,83.3,0,0.0
MERCEDES BENZ,VANEO,2006,2,0,0.0,2,100.0,0,0.0
MERCEDES BENZ,VANEO,2007,1,0,0.0,1,100.0,0,0.0
MERCEDES BENZ,VIANO,2000,1,0,0.0,1,100.0,0,0.0
MERCEDES BENZ,VIANO,2006,2,0,0.0,2,100.0,0,0.0
MERCEDES BENZ,VIANO,2007,1,0,0.0,1,100.0,0,0.0
MERCEDES BENZ,VIANO,2008,3,1,33.3,2,66.7,0,0.0
MERCEDES BENZ,VIANO,2011,1,1,100.0,0,0.0,0,0.0
MERCEDES BENZ,VIANO,2012,3,1,33.3,2,66.7,0,0.0
MERCEDES BENZ,VIANO,2013,2,1,50.0,1,50.0,0,0.0
MERCEDES BENZ,VIANO,2014,1,1,100.0,0,0.0,0,0.0
MERCEDES BENZ,VIANO,2015,1,0,0.0,1,100.0,0,0.0
MERCEDES BENZ,VIANO,2016,3,3,100.0,0,0.0,0,0.0
MERCEDES BENZ,VIANO,2017,3,3,100.0,0,0.0,0,0.0
MERCEDES BENZ,VITO,2004,3,0,0.0,3,100.0,0,0.0
MERCEDES BENZ,VITO,2011,1,1,100.0,0,0.0,0,0.0
MERCEDES BENZ,VITO,2012,3,2,66.7,1,33.3,0,0.0
MERCEDES BENZ,VITO,2014,5,2,40.0,3,60.0,0,0.0
MERCEDES BENZ,VITO,2015,2,1,50.0,1,50.0,0,0.0
MERCEDES BENZ,VITO,2016,5,3,60.0,2,40.0,0,0.0
MERCEDES BENZ,VITO,2017,10,8,80.0,2,20.0,0,0.0
MERCEDES BENZ,VITO 111 CDI,2002,1,0,0.0,1,100.0,0,0.0
MERCEDES/COMPASS,OTHER,1998,1,0,0.0,1,100.0,0,0.0
METROCAB,TAXI (6 SEATER) 04DR A,1997,2,1,50.0,1,50.0,0,0.0
MG,1800,1996,4,1,25.0,3,75.0,0,0.0
MG,1800,1997,2,1,50.0,1,50.0,0,0.0
MG,1800,1998,5,2,40.0,3,60.0,0,0.0
MG,1800,1999,7,3,42.9,4,57.1,0,0.0
MG,1800,2000,1,0,0.0,1,100.0,0,0.0
MG,MG 6,2014,1,1,100.0,0,0.0,0,0.0
MG,MG3,2015,1,0,0.0,1,100.0,0,0.0
MG,MGB,1980,2,0,0.0,2,100.0,0,0.0
MG,MGB,1981,2,0,0.0,2,100.0,0,0.0
MG,MGB,1988,1,0,0.0,1,100.0,0,0.0
MG,OTHER,1980,1,0,0.0,1,100.0,0,0.0
MG,OTHER,2000,7,2,28.6,5,71.4,0,0.0
MG,OTHER,2002,31,11,35.5,20,64.5,0,0.0
MG,OTHER,2004,11,6,54.5,5,45.5,0,0.0
MG,OTHER,2005,41,13,31.7,28,68.3,0,0.0
MG,OTHER,2006,1,0,0.0,1,100.0,0,0.0
MG,OTHER,2009,1,0,0.0,1,100.0,0,0.0
MG,OTHER,2010,1,0,0.0,1,100.0,0,0.0
MG,TF,2002,2,1,50.0,1,50.0,0,0.0
MG,TF,2003,1,0,0.0,1,100.0,0,0.0
MG,TF,2004,4,1,25.0,3,75.0,0,0.0
MG,TF,2005,1,0,0.0,1,100.0,0,0.0
MG,ZR,2002,3,2,66.7,1,33.3,0,0.0
MG,ZR,2003,25,7,28.0,18,72.0,0,0.0
MG,ZR,2004,29,6,20.7,23,79.3,0,0.0
MG,ZR,2005,45,11,24.4,34,75.6,0,0.0
MG,ZR,2006,5,2,40.0,3,60.0,0,0.0
MG,ZT-T,2004,1,0,0.0,1,100.0,0,0.0
MINI,COOPER,2001,44,12,27.3,32,72.7,0,0.0
MINI,COOPER,2002,342,85,24.9,257,75.1,0,0.0
MINI,COOPER,2003,453,151,33.3,302,66.7,0,0.0
MINI,COOPER,2004,588,211,35.9,377,64.1,0,0.0
MINI,COOPER,2005,650,270,41.5,380,58.5,0,0.0
MINI,COOPER,2006,492,207,42.1,285,57.9,0,0.0
MINI,COOPER,2007,911,448,49.2,463,50.8,0,0.0
MINI,COOPER,2008,636,322,50.6,314,49.4,0,0.0
MINI,COOPER,2009,236,134,56.8,102,43.2,0,0.0
MINI,COOPER,2010,518,330,63.7,188,36.3,1,0.2
MINI,COOPER,2011,139,99,71.2,40,28.8,0,0.0
MINI,COOPER,2012,273,204,74.7,69,25.3,0,0.0
MINI,COOPER,2013,99,80,80.8,19,19.2,0,0.0
MINI,COOPER,2014,430,362,84.2,68,15.8,0,0.0
MINI,COOPER,2015,33,29,87.9,4,12.1,0,0.0
MINI,COOPER,2016,3,2,66.7,1,33.3,0,0.0
MINI,COOPER 1.6,2003,1,0,0.0,1,100.0,0,0.0
MINI,COOPER 1.6 S 3DR,2008,1,1,100.0,0,0.0,0,0.0
MINI,COOPER 1.6 S CHILI 3DR,2007,1,0,0.0,1,100.0,0,0.0
MINI,COOPER 1.6S 170BHP 3DR,2003,1,0,0.0,1,100.0,0,0.0
MINI,COOPER S,2002,1,1,100.0,0,0.0,0,0.0
MINI,COOPER S,2003,1,0,0.0,1,100.0,0,0.0
MINI,COOPER S,2005,4,2,50.0,2,50.0,0,0.0
MINI,COOPER S,2006,112,52,46.4,60,53.6,0,0.0
MINI,COOPER S,2007,115,51,44.3,64,55.7,0,0.0
MINI,COOPER S,2008,41,22,53.7,19,46.3,0,0.0
MINI,COOPER S,2009,5,5,100.0,0,0.0,0,0.0
MINI,FIRST,2009,9,4,44.4,5,55.6,0,0.0
MINI,FIRST,2010,92,63,68.5,29,31.5,0,0.0
MINI,FIRST,2011,11,5,45.5,6,54.5,0,0.0
MINI,FIRST,2012,113,89,78.8,24,21.2,0,0.0
MINI,FIRST,2013,7,5,71.4,2,28.6,0,0.0
MINI,FIRST,2014,15,12,80.0,3,20.0,0,0.0
MINI,ONE,2001,31,7,22.6,24,77.4,0,0.0
MINI,ONE,2002,180,47,26.1,133,73.9,0,0.0
MINI,ONE,2003,330,96,29.1,234,70.9,0,0.0
MINI,ONE,2004,487,154,31.6,333,68.4,0,0.0
MINI,ONE,2005,640,234,36.6,406,63.4,0,0.0
MINI,ONE,2006,504,201,39.9,303,60.1,0,0.0
MINI,ONE,2007,431,187,43.4,244,56.6,0,0.0
MINI,ONE,2008,376,160,42.6,216,57.4,0,0.0
MINI,ONE,2009,72,37,51.4,35,48.6,0,0.0
MINI,ONE,2010,98,54,55.1,44,44.9,0,0.0
MINI,ONE,2011,69,36,52.2,33,47.8,0,0.0
MINI,ONE,2012,213,161,75.6,52,24.4,0,0.0
MINI,ONE,2013,44,29,65.9,15,34.1,0,0.0
MINI,ONE,2014,205,171,83.4,34,16.6,0,0.0
MINI,ONE,2015,26,22,84.6,4,15.4,0,0.0
MINI,ONE,2016,4,4,100.0,0,0.0,0,0.0
MINI,ONE 1.6 3DR,2004,1,1,100.0,0,0.0,0,0.0
MINI,ONE CABRIOLET,2004,1,0,0.0,1,100.0,0,0.0
MINI,OTHER,2002,4,2,50.0,2,50.0,0,0.0
MINI,OTHER,2004,2,2,100.0,0,0.0,0,0.0
MINI,OTHER,2005,21,5,23.8,16,76.2,0,0.0
MINI,OTHER,2006,2,1,50.0,1,50.0,0,0.0
MINI,OTHER,2012,3,2,66.7,1,33.3,0,0.0
MINI,OTHER,2013,1,1,100.0,0,0.0,0,0.0
MINI,OTHER,2014,13,12,92.3,1,7.7,0,0.0
MINI,OTHER,2015,8,7,87.5,1,12.5,0,0.0
MITSUBISHI,AIRTREK,2002,1,1,100.0,0,0.0,0,0.0
MITSUBISHI,AIRTREK,2003,1,1,100.0,0,0.0,0,0.0
MITSUBISHI,AIRTREK,2004,1,0,0.0,1,100.0,0,0.0
MITSUBISHI,ASX,2010,43,27,62.8,16,37.2,0,0.0
MITSUBISHI,ASX,2011,37,29,78.4,8,21.6,0,0.0
MITSUBISHI,ASX,2012,52,35,67.3,17,32.7,0,0.0
MITSUBISHI,ASX,2013,18,17,94.4,1,5.6,0,0.0
MITSUBISHI,ASX,2014,235,177,75.3,58,24.7,0,0.0
MITSUBISHI,ASX,2015,31,24,77.4,7,22.6,0,0.0
MITSUBISHI,ASX,2016,1,1,100.0,0,0.0,0,0.0
MITSUBISHI,ASX,2017,1,1,100.0,0,0.0,0,0.0
MITSUBISHI,CARISMA,1996,5,1,20.0,4,80.0,0,0.0
MITSUBISHI,CARISMA,1997,8,2,25.0,6,75.0,0,0.0
MITSUBISHI,CARISMA,1998,18,6,33.3,12,66.7,0,0.0
MITSUBISHI,CARISMA,1999,21,7,33.3,14,66.7,0,0.0
MITSUBISHI,CARISMA,2000,50,18,36.0,32,64.0,0,0.0
MITSUBISHI,CARISMA,2001,34,10,29.4,24,70.6,0,0.0
MITSUBISHI,CARISMA,2002,127,41,32.3,86,67.7,0,0.0
MITSUBISHI,CARISMA,2003,183,55,30.1,128,69.9,0,0.0
MITSUBISHI,CARISMA,2004,120,39,32.5,81,67.5,0,0.0
MITSUBISHI,CARISMA,2005,9,2,22.2,7,77.8,0,0.0
MITSUBISHI,COLT,1990,1,1,100.0,0,0.0,0,0.0
MITSUBISHI,COLT,1992,1,1,100.0,0,0.0,0,0.0
MITSUBISHI,COLT,1993,9,4,44.4,5,55.6,0,0.0
MITSUBISHI,COLT,1994,5,2,40.0,3,60.0,0,0.0
MITSUBISHI,COLT,1995,2,0,0.0,2,100.0,0,0.0
MITSUBISHI,COLT,1996,5,0,0.0,5,100.0,0,0.0
MITSUBISHI,COLT,1997,20,5,25.0,15,75.0,0,0.0
MITSUBISHI,COLT,1998,32,7,21.9,25,78.1,0,0.0
MITSUBISHI,COLT,1999,53,16,30.2,37,69.8,0,0.0
MITSUBISHI,COLT,2000,141,46,32.6,95,67.4,0,0.0
MITSUBISHI,COLT,2001,103,32,31.1,71,68.9,0,0.0
MITSUBISHI,COLT,2002,116,33,28.4,83,71.6,0,0.0
MITSUBISHI,COLT,2003,175,51,29.1,124,70.9,0,0.0
MITSUBISHI,COLT,2004,209,92,44.0,117,56.0,0,0.0
MITSUBISHI,COLT,2005,772,392,50.8,380,49.2,1,0.1
MITSUBISHI,COLT,2006,710,385,54.2,325,45.8,1,0.1
MITSUBISHI,COLT,2007,783,423,54.0,360,46.0,1,0.1
MITSUBISHI,COLT,2008,393,232,59.0,161,41.0,0,0.0
MITSUBISHI,COLT,2009,151,99,65.6,52,34.4,0,0.0
MITSUBISHI,COLT,2010,291,192,66.0,99,34.0,0,0.0
MITSUBISHI,COLT,2011,35,28,80.0,7,20.0,0,0.0
MITSUBISHI,COLT,2012,91,68,74.7,23,25.3,0,0.0
MITSUBISHI,COLT,2013,5,3,60.0,2,40.0,0,0.0
MITSUBISHI,COLT,2014,6,5,83.3,1,16.7,0,0.0
MITSUBISHI,DELICA,2000,1,0,0.0,1,100.0,0,0.0
MITSUBISHI,DELICA,2011,1,1,100.0,0,0.0,0,0.0
MITSUBISHI,DELICA PA5W 4DR A,1998,1,0,0.0,1,100.0,0,0.0
MITSUBISHI,EX WAGON,2003,2,2,100.0,0,0.0,0,0.0
MITSUBISHI,GALANT,1990,1,0,0.0,1,100.0,0,0.0
MITSUBISHI,GALANT,1991,1,0,0.0,1,100.0,0,0.0
MITSUBISHI,GALANT,1992,1,0,0.0,1,100.0,0,0.0
MITSUBISHI,GALANT,1994,2,1,50.0,1,50.0,0,0.0
MITSUBISHI,GALANT,1995,1,0,0.0,1,100.0,0,0.0
MITSUBISHI,GALANT,1996,1,0,0.0,1,100.0,0,0.0
MITSUBISHI,GALANT,1997,1,0,0.0,1,100.0,0,0.0
MITSUBISHI,GALANT,1998,3,1,33.3,2,66.7,0,0.0
MITSUBISHI,GALANT,1999,4,1,25.0,3,75.0,0,0.0
MITSUBISHI,GALANT,2000,13,5,38.5,8,61.5,0,0.0
MITSUBISHI,GALANT,2001,17,3,17.6,14,82.4,0,0.0
MITSUBISHI,GALANT,2002,19,4,21.1,15,78.9,0,0.0
MITSUBISHI,GALANT,2003,5,3,60.0,2,40.0,0,0.0
MITSUBISHI,GALANT,2004,14,6,42.9,8,57.1,0,0.0
MITSUBISHI,GRANDIS,2004,7,2,28.6,5,71.4,0,0.0
MITSUBISHI,GRANDIS,2005,26,6,23.1,20,76.9,0,0.0
MITSUBISHI,GRANDIS,2006,16,5,31.3,11,68.8,0,0.0
MITSUBISHI,GRANDIS,2007,9,6,66.7,3,33.3,0,0.0
MITSUBISHI,GRANDIS,2008,69,28,40.6,41,59.4,0,0.0
MITSUBISHI,GRANDIS,2009,13,5,38.5,8,61.5,0,0.0
MITSUBISHI,GRANDIS,2010,50,20,40.0,30,60.0,0,0.0
MITSUBISHI,GRANDIS,2011,1,1,100.0,0,0.0,0,0.0
MITSUBISHI,GT3000,2000,1,0,0.0,1,100.0,0,0.0
MITSUBISHI,GTO,1995,1,0,0.0,1,100.0,0,0.0
MITSUBISHI,I-MIEV,2007,3,1,33.3,2,66.7,0,0.0
MITSUBISHI,I-MIEV,2010,12,8,66.7,4,33.3,0,0.0
MITSUBISHI,I-MIEV,2012,1,0,0.0,1,100.0,0,0.0
MITSUBISHI,LANCER,1988,1,1,100.0,0,0.0,0,0.0
MITSUBISHI,LANCER,1989,1,0,0.0,1,100.0,0,0.0
MITSUBISHI,LANCER,1992,5,3,60.0,2,40.0,0,0.0
MITSUBISHI,LANCER,1993,4,1,25.0,3,75.0,0,0.0
MITSUBISHI,LANCER,1994,4,0,0.0,4,100.0,0,0.0
MITSUBISHI,LANCER,1995,15,4,26.7,11,73.3,0,0.0
MITSUBISHI,LANCER,1996,25,6,24.0,19,76.0,0,0.0
MITSUBISHI,LANCER,1997,23,7,30.4,16,69.6,0,0.0
MITSUBISHI,LANCER,1998,77,29,37.7,48,62.3,0,0.0
MITSUBISHI,LANCER,1999,76,20,26.3,56,73.7,0,0.0
MITSUBISHI,LANCER,2000,83,20,24.1,63,75.9,0,0.0
MITSUBISHI,LANCER,2001,103,29,28.2,74,71.8,0,0.0
MITSUBISHI,LANCER,2002,13,1,7.7,12,92.3,0,0.0
MITSUBISHI,LANCER,2003,62,12,19.4,50,80.6,0,0.0
MITSUBISHI,LANCER,2004,565,198,35.0,367,65.0,1,0.2
MITSUBISHI,LANCER,2005,593,224,37.8,369,62.2,0,0.0
MITSUBISHI,LANCER,2006,499,204,40.9,295,59.1,0,0.0
MITSUBISHI,LANCER,2007,274,110,40.1,164,59.9,0,0.0
MITSUBISHI,LANCER,2008,429,179,41.7,250,58.3,0,0.0
MITSUBISHI,LANCER,2009,102,62,60.8,40,39.2,0,0.0
MITSUBISHI,LANCER,2010,266,195,73.3,71,26.7,0,0.0
MITSUBISHI,LANCER,2011,36,26,72.2,10,27.8,0,0.0
MITSUBISHI,LANCER,2012,118,92,78.0,26,22.0,0,0.0
MITSUBISHI,LANCER,2013,19,15,78.9,4,21.1,0,0.0
MITSUBISHI,LANCER,2014,62,53,85.5,9,14.5,0,0.0
MITSUBISHI,LANCER,2015,19,18,94.7,1,5.3,0,0.0
MITSUBISHI,LANCER,2016,5,4,80.0,1,20.0,0,0.0
MITSUBISHI,LANCER,2017,2,1,50.0,1,50.0,0,0.0
MITSUBISHI,LANCER CT 9A RS EVO VII 4DR,2001,1,0,0.0,1,100.0,0,0.0
MITSUBISHI,LANCER EVO,1996,1,0,0.0,1,100.0,0,0.0
MITSUBISHI,LANCER EVO,1998,1,0,0.0,1,100.0,0,0.0
MITSUBISHI,LANCER EVO,2001,3,3,100.0,0,0.0,0,0.0
MITSUBISHI,LANCER EVO,2002,2,0,0.0,2,100.0,0,0.0
MITSUBISHI,LANCER EVO,2005,3,0,0.0,3,100.0,1,33.3
MITSUBISHI,LANCER EVO,2006,3,1,33.3,2,66.7,0,0.0
MITSUBISHI,LANCER EVO,2007,3,2,66.7,1,33.3,0,0.0
MITSUBISHI,LANCER EVO,2008,1,1,100.0,0,0.0,0,0.0
MITSUBISHI,LANCER EVO V111 MR FQ-300,2004,1,0,0.0,1,100.0,0,0.0
MITSUBISHI,MIRAGE,1997,1,0,0.0,1,100.0,0,0.0
MITSUBISHI,MIRAGE,2012,5,5,100.0,0,0.0,0,0.0
MITSUBISHI,MIRAGE,2013,15,13,86.7,2,13.3,0,0.0
MITSUBISHI,MIRAGE,2014,16,15,93.8,1,6.3,0,0.0
MITSUBISHI,MIRAGE,2016,1,1,100.0,0,0.0,0,0.0
MITSUBISHI,OTHER,1987,2,1,50.0,1,50.0,0,0.0
MITSUBISHI,OTHER,1988,1,0,0.0,1,100.0,0,0.0
MITSUBISHI,OTHER,1989,4,1,25.0,3,75.0,0,0.0
MITSUBISHI,OTHER,1990,2,1,50.0,1,50.0,0,0.0
MITSUBISHI,OTHER,1991,7,1,14.3,6,85.7,0,0.0
MITSUBISHI,OTHER,1992,11,3,27.3,8,72.7,0,0.0
MITSUBISHI,OTHER,1993,6,2,33.3,4,66.7,0,0.0
MITSUBISHI,OTHER,1994,6,3,50.0,3,50.0,0,0.0
MITSUBISHI,OTHER,1995,15,2,13.3,13,86.7,0,0.0
MITSUBISHI,OTHER,1996,18,3,16.7,15,83.3,0,0.0
MITSUBISHI,OTHER,1997,21,8,38.1,13,61.9,0,0.0
MITSUBISHI,OTHER,1998,31,8,25.8,23,74.2,0,0.0
MITSUBISHI,OTHER,1999,26,7,26.9,19,73.1,0,0.0
MITSUBISHI,OTHER,2000,17,6,35.3,11,64.7,0,0.0
MITSUBISHI,OTHER,2001,5,0,0.0,5,100.0,0,0.0
MITSUBISHI,OTHER,2002,11,3,27.3,8,72.7,0,0.0
MITSUBISHI,OTHER,2003,6,2,33.3,4,66.7,0,0.0
MITSUBISHI,OTHER,2004,16,5,31.3,11,68.8,0,0.0
MITSUBISHI,OTHER,2005,25,8,32.0,17,68.0,0,0.0
MITSUBISHI,OTHER,2006,111,31,27.9,80,72.1,0,0.0
MITSUBISHI,OTHER,2007,122,39,32.0,83,68.0,0,0.0
MITSUBISHI,OTHER,2008,9,2,22.2,7,77.8,0,0.0
MITSUBISHI,OTHER,2009,4,4,100.0,0,0.0,0,0.0
MITSUBISHI,OTHER,2011,1,1,100.0,0,0.0,0,0.0
MITSUBISHI,OUTLANDER,2003,1,0,0.0,1,100.0,0,0.0
MITSUBISHI,OUTLANDER,2004,9,3,33.3,6,66.7,0,0.0
MITSUBISHI,OUTLANDER,2005,7,4,57.1,3,42.9,0,0.0
MITSUBISHI,OUTLANDER,2006,1,0,0.0,1,100.0,0,0.0
MITSUBISHI,OUTLANDER,2007,252,91,36.1,161,63.9,0,0.0
MITSUBISHI,OUTLANDER,2008,141,53,37.6,88,62.4,0,0.0
MITSUBISHI,OUTLANDER,2009,23,15,65.2,8,34.8,0,0.0
MITSUBISHI,OUTLANDER,2010,96,45,46.9,51,53.1,0,0.0
MITSUBISHI,OUTLANDER,2011,12,8,66.7,4,33.3,0,0.0
MITSUBISHI,OUTLANDER,2012,30,15,50.0,15,50.0,0,0.0
MITSUBISHI,OUTLANDER,2013,42,26,61.9,16,38.1,0,0.0
MITSUBISHI,OUTLANDER,2014,341,227,66.6,114,33.4,0,0.0
MITSUBISHI,OUTLANDER,2015,53,44,83.0,9,17.0,0,0.0
MITSUBISHI,OUTLANDER,2016,3,2,66.7,1,33.3,0,0.0
MITSUBISHI,PAJERO,1988,1,0,0.0,1,100.0,0,0.0
MITSUBISHI,PAJERO,1989,1,0,0.0,1,100.0,0,0.0
MITSUBISHI,PAJERO,1990,2,1,50.0,1,50.0,0,0.0
MITSUBISHI,PAJERO,1991,1,0,0.0,1,100.0,0,0.0
MITSUBISHI,PAJERO,1992,3,2,66.7,1,33.3,0,0.0
MITSUBISHI,PAJERO,1993,3,1,33.3,2,66.7,0,0.0
MITSUBISHI,PAJERO,1994,4,1,25.0,3,75.0,0,0.0
MITSUBISHI,PAJERO,1995,20,9,45.0,11,55.0,0,0.0
MITSUBISHI,PAJERO,1996,95,25,26.3,70,73.7,1,1.1
MITSUBISHI,PAJERO,1997,101,32,31.7,69,68.3,0,0.0
MITSUBISHI,PAJERO,1998,43,10,23.3,33,76.7,0,0.0
MITSUBISHI,PAJERO,1999,18,1,5.6,17,94.4,0,0.0
MITSUBISHI,PAJERO,2000,23,5,21.7,18,78.3,0,0.0
MITSUBISHI,PAJERO,2001,24,11,45.8,13,54.2,0,0.0
MITSUBISHI,PAJERO,2002,30,6,20.0,24,80.0,0,0.0
MITSUBISHI,PAJERO,2003,35,11,31.4,24,68.6,0,0.0
MITSUBISHI,PAJERO,2004,38,8,21.1,30,78.9,0,0.0
MITSUBISHI,PAJERO,2005,65,24,36.9,41,63.1,0,0.0
MITSUBISHI,PAJERO,2006,71,23,32.4,48,67.6,0,0.0
MITSUBISHI,PAJERO,2007,50,22,44.0,28,56.0,1,2.0
MITSUBISHI,PAJERO,2008,11,6,54.5,5,45.5,0,0.0
MITSUBISHI,PAJERO,2010,7,3,42.9,4,57.1,0,0.0
MITSUBISHI,PAJERO,2011,2,1,50.0,1,50.0,0,0.0
MITSUBISHI,PAJERO,2012,5,2,40.0,3,60.0,0,0.0
MITSUBISHI,PAJERO,2013,1,1,100.0,0,0.0,0,0.0
MITSUBISHI,PAJERO,2014,3,3,100.0,0,0.0,0,0.0
MITSUBISHI,PAJERO,2015,2,2,100.0,0,0.0,0,0.0
MITSUBISHI,SHOGUN,2003,2,0,0.0,2,100.0,0,0.0
MITSUBISHI,SHOGUN,2004,4,1,25.0,3,75.0,0,0.0
MITSUBISHI,SHOGUN,2005,7,3,42.9,4,57.1,0,0.0
MITSUBISHI,SHOGUN,2006,5,0,0.0,5,100.0,0,0.0
MITSUBISHI,SHOGUN,2007,1,1,100.0,0,0.0,0,0.0
MITSUBISHI,SHOGUN,2010,1,1,100.0,0,0.0,0,0.0
MITSUBISHI,SHOGUN,2014,1,1,100.0,0,0.0,0,0.0
MITSUBISHI,SHOGUN SPORT 2.5TD WARRIOR 05D,2006,1,0,0.0,1,100.0,0,0.0
MITSUBISHI,SPACESTAR,1998,1,0,0.0,1,100.0,0,0.0
MITSUBISHI,SPACESTAR,1999,34,6,17.6,28,82.4,0,0.0
MITSUBISHI,SPACESTAR,2000,58,16,27.6,42,72.4,0,0.0
MITSUBISHI,SPACESTAR,2001,42,11,26.2,31,73.8,0,0.0
MITSUBISHI,SPACESTAR,2002,59,18,30.5,41,69.5,0,0.0
MITSUBISHI,SPACESTAR,2003,126,28,22.2,98,77.8,0,0.0
MITSUBISHI,SPACESTAR,2004,173,45,26.0,128,74.0,0,0.0
MITSUBISHI,SPACESTAR,2005,63,15,23.8,48,76.2,0,0.0
MITSUBISHI,SPACESTAR,2013,8,6,75.0,2,25.0,0,0.0
MITSUBISHI,SPACESTAR,2014,129,116,89.9,13,10.1,0,0.0
MITSUBISHI,SPACESTAR,2015,18,16,88.9,2,11.1,0,0.0
MITSUBISHI,SPACEWAGON,1995,1,0,0.0,1,100.0,0,0.0
MITSUBISHI,SPACEWAGON,1997,3,0,0.0,3,100.0,0,0.0
MITSUBISHI,SPACEWAGON,1998,2,0,0.0,2,100.0,0,0.0
MITSUBISHI,SPACEWAGON,1999,11,1,9.1,10,90.9,0,0.0
MITSUBISHI,SPACEWAGON,2000,11,2,18.2,9,81.8,0,0.0
MITSUBISHI,SPACEWAGON,2001,9,5,55.6,4,44.4,0,0.0
MITSUBISHI,SPACEWAGON,2002,13,5,38.5,8,61.5,0,0.0
MITSUBISHI,SPACEWAGON,2003,24,9,37.5,15,62.5,0,0.0
MITSUBISHI,SPACEWAGON,2004,3,3,100.0,0,0.0,0,0.0
MITSUOKA,OTHER,1996,1,1,100.0,0,0.0,0,0.0
MITSUOKA,VIEWT,1995,2,0,0.0,2,100.0,0,0.0
MITSUOKA,VIEWT,1998,1,1,100.0,0,0.0,0,0.0
MITSUOKA,VIEWT,1999,1,0,0.0,1,100.0,0,0.0
MORGAN,04-Apr,1994,1,0,0.0,1,100.0,0,0.0
MORGAN,OTHER,1980,1,0,0.0,1,100.0,0,0.0
MORGAN,OTHER,1983,1,1,100.0,0,0.0,0,0.0
MORGAN,OTHER,1987,1,1,100.0,0,0.0,0,0.0
MORGAN,OTHER,1989,1,0,0.0,1,100.0,0,0.0
MORGAN,OTHER,1994,1,0,0.0,1,100.0,0,0.0
MORGAN,OTHER,1995,1,0,0.0,1,100.0,0,0.0
MORGAN,OTHER,1998,3,1,33.3,2,66.7,0,0.0
MORGAN,OTHER,2000,3,3,100.0,0,0.0,0,0.0
MORGAN,OTHER,2001,1,1,100.0,0,0.0,0,0.0
MORGAN,OTHER,2005,1,1,100.0,0,0.0,0,0.0
MORGAN,OTHER,2006,2,1,50.0,1,50.0,0,0.0
MORGAN,OTHER,2007,3,2,66.7,1,33.3,0,0.0
MORGAN,OTHER,2010,1,1,100.0,0,0.0,0,0.0
MORRIS,MINOR,1970,1,0,0.0,1,100.0,0,0.0
NEUSON,OTHER,2006,2,0,0.0,2,100.0,0,0.0
NISSAN,180 SX,1991,2,0,0.0,2,100.0,0,0.0
NISSAN,180 SX,1992,1,0,0.0,1,100.0,0,0.0
NISSAN,180 SX,1994,2,0,0.0,2,100.0,0,0.0
NISSAN,180 SX,1995,1,0,0.0,1,100.0,0,0.0
NISSAN,180 SX,1997,5,1,20.0,4,80.0,0,0.0
NISSAN,180 SX,1998,5,0,0.0,5,100.0,0,0.0
NISSAN,200 SX,1991,6,1,16.7,5,83.3,0,0.0
NISSAN,200 SX,1994,2,0,0.0,2,100.0,0,0.0
NISSAN,200 SX,1995,1,0,0.0,1,100.0,0,0.0
NISSAN,200 SX,1996,3,0,0.0,3,100.0,0,0.0
NISSAN,200 SX,1997,3,0,0.0,3,100.0,0,0.0
NISSAN,200 SX,1998,14,3,21.4,11,78.6,0,0.0
NISSAN,200 SX,1999,13,4,30.8,9,69.2,0,0.0
NISSAN,200 SX,2000,9,1,11.1,8,88.9,0,0.0
NISSAN,200 SX,2001,1,0,0.0,1,100.0,0,0.0
NISSAN,300 ZX,1986,2,0,0.0,2,100.0,0,0.0
NISSAN,300 ZX,1988,1,0,0.0,1,100.0,0,0.0
NISSAN,300 ZX,1991,5,1,20.0,4,80.0,0,0.0
NISSAN,300 ZX,1994,1,1,100.0,0,0.0,0,0.0
NISSAN,300 ZX,1995,2,1,50.0,1,50.0,0,0.0
NISSAN,300 ZX,2000,1,1,100.0,0,0.0,0,0.0
NISSAN,350Z,2002,2,1,50.0,1,50.0,0,0.0
NISSAN,350Z,2003,1,0,0.0,1,100.0,0,0.0
NISSAN,350Z,2004,16,7,43.8,9,56.3,0,0.0
NISSAN,350Z,2005,6,4,66.7,2,33.3,0,0.0
NISSAN,350Z,2006,5,2,40.0,3,60.0,0,0.0
NISSAN,350Z,2007,9,7,77.8,2,22.2,0,0.0
NISSAN,350Z,2008,4,3,75.0,1,25.0,0,0.0
NISSAN,350Z,2011,1,1,100.0,0,0.0,0,0.0
NISSAN,370Z,2008,1,0,0.0,1,100.0,0,0.0
NISSAN,ALMERA,1995,6,2,33.3,4,66.7,0,0.0
NISSAN,ALMERA,1996,61,16,26.2,45,73.8,0,0.0
NISSAN,ALMERA,1997,112,33,29.5,79,70.5,0,0.0
NISSAN,ALMERA,1998,139,38,27.3,101,72.7,0,0.0
NISSAN,ALMERA,1999,415,118,28.4,297,71.6,0,0.0
NISSAN,ALMERA,2000,910,261,28.7,649,71.3,0,0.0
NISSAN,ALMERA,2001,752,227,30.2,525,69.8,0,0.0
NISSAN,ALMERA,2002,1189,410,34.5,779,65.5,0,0.0
NISSAN,ALMERA,2003,1609,609,37.8,1000,62.2,0,0.0
NISSAN,ALMERA,2004,2615,1123,42.9,1492,57.1,0,0.0
NISSAN,ALMERA,2005,4095,1716,41.9,2379,58.1,14,0.3
NISSAN,ALMERA,2006,3319,1543,46.5,1776,53.5,15,0.5
NISSAN,ALMERA,2007,2388,1136,47.6,1252,52.4,3,0.1
NISSAN,ALMERA,2008,56,25,44.6,31,55.4,0,0.0
NISSAN,ALMERA,2009,2,0,0.0,2,100.0,0,0.0
NISSAN,ALMERA,2010,2,2,100.0,0,0.0,0,0.0
NISSAN,ALMERA 1.5 S 5DR,2006,1,1,100.0,0,0.0,0,0.0
NISSAN,BLUEBIRD,1983,2,1,50.0,1,50.0,0,0.0
NISSAN,BLUEBIRD,1985,1,0,0.0,1,100.0,0,0.0
NISSAN,BLUEBIRD,1986,3,2,66.7,1,33.3,0,0.0
NISSAN,BLUEBIRD,1987,3,1,33.3,2,66.7,0,0.0
NISSAN,BLUEBIRD,1988,3,2,66.7,1,33.3,0,0.0
NISSAN,BLUEBIRD,1989,7,3,42.9,4,57.1,0,0.0
NISSAN,BLUEBIRD,1990,6,2,33.3,4,66.7,0,0.0
NISSAN,BLUEBIRD,2005,1,1,100.0,0,0.0,0,0.0
NISSAN,CARAVAN,2004,1,0,0.0,1,100.0,0,0.0
NISSAN,CHERRY,1982,1,0,0.0,1,100.0,0,0.0
NISSAN,CIMA,2014,1,0,0.0,1,100.0,0,0.0
NISSAN,CUBE,2002,1,0,0.0,1,100.0,0,0.0
NISSAN,CUBE,2003,5,1,20.0,4,80.0,0,0.0
NISSAN,CUBE,2004,25,12,48.0,13,52.0,0,0.0
NISSAN,CUBE,2005,25,10,40.0,15,60.0,0,0.0
NISSAN,CUBE,2006,20,9,45.0,11,55.0,0,0.0
NISSAN,CUBE,2007,24,13,54.2,11,45.8,0,0.0
NISSAN,CUBE,2008,7,4,57.1,3,42.9,0,0.0
NISSAN,CUBE,2009,3,1,33.3,2,66.7,0,0.0
NISSAN,CUBE,2010,5,1,20.0,4,80.0,0,0.0
NISSAN,CUBE,2011,2,2,100.0,0,0.0,0,0.0
NISSAN,CUBE,2012,2,1,50.0,1,50.0,0,0.0
NISSAN,CUBE,2014,1,1,100.0,0,0.0,0,0.0
NISSAN,CUBE,2016,1,1,100.0,0,0.0,0,0.0
NISSAN,DUALIS,2011,1,1,100.0,0,0.0,0,0.0
NISSAN,DUALIS,2012,1,1,100.0,0,0.0,0,0.0
NISSAN,ELGRAND,2007,1,1,100.0,0,0.0,0,0.0
NISSAN,ENV200,2015,1,1,100.0,0,0.0,0,0.0
NISSAN,FAIRLADY 2 GCZ32 TWIN TURBO 2D,2007,2,2,100.0,0,0.0,0,0.0
NISSAN,FAIRLADY Z,1993,1,0,0.0,1,100.0,0,0.0
NISSAN,FIGARO,1991,11,1,9.1,10,90.9,0,0.0
NISSAN,GTR,2009,2,1,50.0,1,50.0,0,0.0
NISSAN,GTR,2010,1,0,0.0,1,100.0,0,0.0
NISSAN,GTR,2011,1,1,100.0,0,0.0,0,0.0
NISSAN,INTERSTAR,2003,1,0,0.0,1,100.0,0,0.0
NISSAN,INTERSTAR,2005,2,0,0.0,2,100.0,0,0.0
NISSAN,INTERSTAR,2006,1,1,100.0,0,0.0,0,0.0
NISSAN,INTERSTAR,2007,2,0,0.0,2,100.0,0,0.0
NISSAN,INTERSTAR,2011,1,0,0.0,1,100.0,0,0.0
NISSAN,JUKE,2010,54,35,64.8,19,35.2,0,0.0
NISSAN,JUKE,2011,232,157,67.7,75,32.3,0,0.0
NISSAN,JUKE,2012,964,734,76.1,230,23.9,0,0.0
NISSAN,JUKE,2013,170,122,71.8,48,28.2,0,0.0
NISSAN,JUKE,2014,786,670,85.2,116,14.8,0,0.0
NISSAN,JUKE,2015,89,80,89.9,9,10.1,0,0.0
NISSAN,KUBISTAR,1986,1,0,0.0,1,100.0,0,0.0
NISSAN,LAFESTA,2005,2,2,100.0,0,0.0,0,0.0
NISSAN,LAFESTA,2006,1,0,0.0,1,100.0,0,0.0
NISSAN,LAFESTA,2007,2,0,0.0,2,100.0,0,0.0
NISSAN,LAFESTA,2008,1,1,100.0,0,0.0,0,0.0
NISSAN,LAFESTA,2012,1,0,0.0,1,100.0,0,0.0
NISSAN,LAUREL,1984,1,1,100.0,0,0.0,0,0.0
NISSAN,LAUREL,1986,1,0,0.0,1,100.0,0,0.0
NISSAN,LAUREL,1990,1,1,100.0,0,0.0,0,0.0
NISSAN,LAUREL,1992,1,1,100.0,0,0.0,0,0.0
NISSAN,LAUREL,1997,5,2,40.0,3,60.0,0,0.0
NISSAN,LAUREL,1998,6,1,16.7,5,83.3,0,0.0
NISSAN,LAUREL,1999,2,1,50.0,1,50.0,0,0.0
NISSAN,LAUREL,2000,4,0,0.0,4,100.0,0,0.0
NISSAN,LAUREL,2001,3,2,66.7,1,33.3,0,0.0
NISSAN,LEAF,2011,15,6,40.0,9,60.0,0,0.0
NISSAN,LEAF,2012,117,82,70.1,35,29.9,8,6.8
NISSAN,LEAF,2013,39,23,59.0,16,41.0,1,2.6
NISSAN,LEAF,2014,404,286,70.8,118,29.2,20,5.0
NISSAN,LEAF,2015,41,35,85.4,6,14.6,1,2.4
NISSAN,LEAF,2016,2,2,100.0,0,0.0,0,0.0
NISSAN,LEAF,2017,2,2,100.0,0,0.0,0,0.0
NISSAN,LEAF,2018,5,5,100.0,0,0.0,0,0.0
NISSAN,MARCH,2011,1,0,0.0,1,100.0,0,0.0
NISSAN,MARCH AK12,2002,3,2,66.7,1,33.3,0,0.0
NISSAN,MARCH AK12,2003,2,2,100.0,0,0.0,0,0.0
NISSAN,MARCH AK12,2004,9,4,44.4,5,55.6,0,0.0
NISSAN,MARCH AK12,2005,10,6,60.0,4,40.0,0,0.0
NISSAN,MARCH AK12,2006,34,25,73.5,9,26.5,0,0.0
NISSAN,MARCH AK12,2007,52,22,42.3,30,57.7,0,0.0
NISSAN,MARCH AK12,2008,67,44,65.7,23,34.3,0,0.0
NISSAN,MARCH AK12,2009,77,46,59.7,31,40.3,0,0.0
NISSAN,MARCH AK12,2010,38,17,44.7,21,55.3,0,0.0
NISSAN,MARCH AK12,2011,44,26,59.1,18,40.9,0,0.0
NISSAN,MARCH AK12,2012,58,40,69.0,18,31.0,0,0.0
NISSAN,MARCH AK12,2013,26,16,61.5,10,38.5,0,0.0
NISSAN,MARCH AK12,2014,2,1,50.0,1,50.0,0,0.0
NISSAN,MARCH AK12,2015,1,0,0.0,1,100.0,0,0.0
NISSAN,MARCH AK12,2016,3,2,66.7,1,33.3,0,0.0
NISSAN,MARCH K11,2000,1,0,0.0,1,100.0,0,0.0
NISSAN,MARCH K11,2001,1,1,100.0,0,0.0,0,0.0
NISSAN,MARCH YK12,2006,1,1,100.0,0,0.0,0,0.0
NISSAN,MAXIMA,1996,5,3,60.0,2,40.0,0,0.0
NISSAN,MAXIMA,1997,2,0,0.0,2,100.0,0,0.0
NISSAN,MAXIMA,1998,6,2,33.3,4,66.7,0,0.0
NISSAN,MAXIMA,1999,4,1,25.0,3,75.0,0,0.0
NISSAN,MAXIMA,2000,9,4,44.4,5,55.6,0,0.0
NISSAN,MAXIMA,2001,17,4,23.5,13,76.5,0,0.0
NISSAN,MAXIMA,2002,22,7,31.8,15,68.2,0,0.0
NISSAN,MAXIMA,2003,19,5,26.3,14,73.7,0,0.0
NISSAN,MAXIMA,2004,26,13,50.0,13,50.0,0,0.0
NISSAN,MAXIMA,2005,4,1,25.0,3,75.0,0,0.0
NISSAN,MICRA,1986,4,2,50.0,2,50.0,0,0.0
NISSAN,MICRA,1987,3,3,100.0,0,0.0,0,0.0
NISSAN,MICRA,1988,4,2,50.0,2,50.0,0,0.0
NISSAN,MICRA,1989,8,3,37.5,5,62.5,0,0.0
NISSAN,MICRA,1990,15,7,46.7,8,53.3,0,0.0
NISSAN,MICRA,1991,13,7,53.8,6,46.2,0,0.0
NISSAN,MICRA,1992,18,6,33.3,12,66.7,0,0.0
NISSAN,MICRA,1993,27,9,33.3,18,66.7,0,0.0
NISSAN,MICRA,1994,32,12,37.5,20,62.5,0,0.0
NISSAN,MICRA,1995,62,27,43.5,35,56.5,0,0.0
NISSAN,MICRA,1996,134,31,23.1,103,76.9,0,0.0
NISSAN,MICRA,1997,375,107,28.5,268,71.5,0,0.0
NISSAN,MICRA,1998,475,131,27.6,344,72.4,0,0.0
NISSAN,MICRA,1999,1061,288,27.1,773,72.9,0,0.0
NISSAN,MICRA,2000,2192,597,27.2,1595,72.8,0,0.0
NISSAN,MICRA,2001,1825,523,28.7,1302,71.3,0,0.0
NISSAN,MICRA,2002,1760,624,35.5,1136,64.5,0,0.0
NISSAN,MICRA,2003,3140,1272,40.5,1868,59.5,0,0.0
NISSAN,MICRA,2004,2859,1268,44.4,1591,55.6,2,0.1
NISSAN,MICRA,2005,2541,1172,46.1,1369,53.9,3,0.1
NISSAN,MICRA,2006,2822,1461,51.8,1361,48.2,0,0.0
NISSAN,MICRA,2007,2131,1135,53.3,996,46.7,0,0.0
NISSAN,MICRA,2008,844,499,59.1,345,40.9,0,0.0
NISSAN,MICRA,2009,509,328,64.4,181,35.6,0,0.0
NISSAN,MICRA,2010,959,652,68.0,307,32.0,0,0.0
NISSAN,MICRA,2011,206,154,74.8,52,25.2,0,0.0
NISSAN,MICRA,2012,1014,793,78.2,221,21.8,0,0.0
NISSAN,MICRA,2013,180,139,77.2,41,22.8,0,0.0
NISSAN,MICRA,2014,923,785,85.0,138,15.0,0,0.0
NISSAN,MICRA,2015,114,96,84.2,18,15.8,0,0.0
NISSAN,MURANO,2005,7,6,85.7,1,14.3,0,0.0
NISSAN,MURANO,2006,8,2,25.0,6,75.0,0,0.0
NISSAN,MURANO,2007,11,2,18.2,9,81.8,0,0.0
NISSAN,MURANO,2008,4,0,0.0,4,100.0,0,0.0
NISSAN,MURANO,2009,1,1,100.0,0,0.0,0,0.0
NISSAN,MURANO,2010,1,1,100.0,0,0.0,0,0.0
NISSAN,MURANO,2011,7,3,42.9,4,57.1,0,0.0
NISSAN,MURANO,2012,1,1,100.0,0,0.0,0,0.0
NISSAN,NOTE,2005,32,15,46.9,17,53.1,0,0.0
NISSAN,NOTE,2006,1649,761,46.1,888,53.9,0,0.0
NISSAN,NOTE,2007,1836,868,47.3,968,52.7,0,0.0
NISSAN,NOTE,2008,638,306,48.0,332,52.0,0,0.0
NISSAN,NOTE,2009,364,199,54.7,165,45.3,0,0.0
NISSAN,NOTE,2010,529,328,62.0,201,38.0,0,0.0
NISSAN,NOTE,2011,88,45,51.1,43,48.9,0,0.0
NISSAN,NOTE,2012,390,286,73.3,104,26.7,0,0.0
NISSAN,NOTE,2013,105,77,73.3,28,26.7,0,0.0
NISSAN,NOTE,2014,997,863,86.6,134,13.4,0,0.0
NISSAN,NOTE,2015,136,125,91.9,11,8.1,0,0.0
NISSAN,NOTE,2016,7,4,57.1,3,42.9,0,0.0
NISSAN,NV200,2010,7,5,71.4,2,28.6,0,0.0
NISSAN,NV200,2011,3,1,33.3,2,66.7,0,0.0
NISSAN,NV200,2012,12,5,41.7,7,58.3,1,8.3
NISSAN,NV200,2013,7,3,42.9,4,57.1,0,0.0
NISSAN,NV200,2014,3,2,66.7,1,33.3,0,0.0
NISSAN,NV200,2015,1,1,100.0,0,0.0,0,0.0
NISSAN,NV200,2018,1,1,100.0,0,0.0,0,0.0
NISSAN,NV300,2017,2,0,0.0,2,100.0,0,0.0
NISSAN,NV400,2012,3,1,33.3,2,66.7,0,0.0
NISSAN,NV400,2013,1,0,0.0,1,100.0,0,0.0
NISSAN,NV400,2014,1,0,0.0,1,100.0,0,0.0
NISSAN,NV400,2015,1,0,0.0,1,100.0,0,0.0
NISSAN,OTHER,1984,1,0,0.0,1,100.0,0,0.0
NISSAN,OTHER,1987,1,1,100.0,0,0.0,0,0.0
NISSAN,OTHER,1989,3,1,33.3,2,66.7,0,0.0
NISSAN,OTHER,1990,7,2,28.6,5,71.4,0,0.0
NISSAN,OTHER,1991,123,38,30.9,85,69.1,0,0.0
NISSAN,OTHER,1992,24,6,25.0,18,75.0,1,4.2
NISSAN,OTHER,1993,18,5,27.8,13,72.2,0,0.0
NISSAN,OTHER,1994,16,3,18.8,13,81.3,0,0.0
NISSAN,OTHER,1995,24,8,33.3,16,66.7,0,0.0
NISSAN,OTHER,1996,28,7,25.0,21,75.0,0,0.0
NISSAN,OTHER,1997,54,20,37.0,34,63.0,0,0.0
NISSAN,OTHER,1998,84,24,28.6,60,71.4,0,0.0
NISSAN,OTHER,1999,80,26,32.5,54,67.5,0,0.0
NISSAN,OTHER,2000,167,59,35.3,108,64.7,0,0.0
NISSAN,OTHER,2001,103,46,44.7,57,55.3,1,1.0
NISSAN,OTHER,2002,58,25,43.1,33,56.9,0,0.0
NISSAN,OTHER,2003,101,35,34.7,66,65.3,0,0.0
NISSAN,OTHER,2004,174,88,50.6,86,49.4,0,0.0
NISSAN,OTHER,2005,181,98,54.1,83,45.9,0,0.0
NISSAN,OTHER,2006,162,101,62.3,61,37.7,0,0.0
NISSAN,OTHER,2007,110,69,62.7,41,37.3,0,0.0
NISSAN,OTHER,2008,51,33,64.7,18,35.3,0,0.0
NISSAN,OTHER,2009,29,18,62.1,11,37.9,0,0.0
NISSAN,OTHER,2010,8,7,87.5,1,12.5,0,0.0
NISSAN,OTHER,2011,2,0,0.0,2,100.0,0,0.0
NISSAN,OTHER,2012,1,0,0.0,1,100.0,0,0.0
NISSAN,OTHER,2013,1,1,100.0,0,0.0,0,0.0
NISSAN,PATHFINDER,2005,33,7,21.2,26,78.8,0,0.0
NISSAN,PATHFINDER,2006,136,38,27.9,98,72.1,0,0.0
NISSAN,PATHFINDER,2007,165,45,27.3,120,72.7,0,0.0
NISSAN,PATHFINDER,2008,37,16,43.2,21,56.8,0,0.0
NISSAN,PATHFINDER,2009,1,0,0.0,1,100.0,0,0.0
NISSAN,PATHFINDER,2011,2,0,0.0,2,100.0,0,0.0
NISSAN,PATHFINDER,2012,1,0,0.0,1,100.0,0,0.0
NISSAN,PATROL,1987,1,1,100.0,0,0.0,0,0.0
NISSAN,PATROL,1989,1,0,0.0,1,100.0,0,0.0
NISSAN,PATROL,1999,1,0,0.0,1,100.0,0,0.0
NISSAN,PATROL,2000,2,1,50.0,1,50.0,0,0.0
NISSAN,PATROL,2001,5,1,20.0,4,80.0,0,0.0
NISSAN,PATROL,2002,3,1,33.3,2,66.7,0,0.0
NISSAN,PATROL,2003,3,1,33.3,2,66.7,0,0.0
NISSAN,PATROL,2004,4,2,50.0,2,50.0,0,0.0
NISSAN,PATROL,2005,8,4,50.0,4,50.0,0,0.0
NISSAN,PATROL,2006,5,1,20.0,4,80.0,0,0.0
NISSAN,PATROL,2007,8,3,37.5,5,62.5,0,0.0
NISSAN,PIXO,2009,13,6,46.2,7,53.8,0,0.0
NISSAN,PIXO,2010,127,97,76.4,30,23.6,0,0.0
NISSAN,PIXO,2011,24,12,50.0,12,50.0,0,0.0
NISSAN,PIXO,2012,26,18,69.2,8,30.8,0,0.0
NISSAN,PRIMASTAR,2003,3,0,0.0,3,100.0,0,0.0
NISSAN,PRIMASTAR,2004,17,4,23.5,13,76.5,0,0.0
NISSAN,PRIMASTAR,2005,27,6,22.2,21,77.8,0,0.0
NISSAN,PRIMASTAR,2006,35,5,14.3,30,85.7,0,0.0
NISSAN,PRIMASTAR,2007,107,29,27.1,78,72.9,0,0.0
NISSAN,PRIMASTAR,2008,51,13,25.5,38,74.5,0,0.0
NISSAN,PRIMASTAR,2009,5,0,0.0,5,100.0,0,0.0
NISSAN,PRIMASTAR,2010,5,2,40.0,3,60.0,0,0.0
NISSAN,PRIMASTAR,2011,14,4,28.6,10,71.4,0,0.0
NISSAN,PRIMASTAR,2012,19,6,31.6,13,68.4,0,0.0
NISSAN,PRIMASTAR,2013,2,2,100.0,0,0.0,0,0.0
NISSAN,PRIMASTAR,2014,6,4,66.7,2,33.3,1,16.7
NISSAN,PRIMASTAR 90 LWB U13 SEATS 6DR,2004,1,1,100.0,0,0.0,0,0.0
NISSAN,PRIMASTAR LWB 115 07 5DR,2007,3,0,0.0,3,100.0,0,0.0
NISSAN,PRIMERA,1990,2,0,0.0,2,100.0,0,0.0
NISSAN,PRIMERA,1991,3,0,0.0,3,100.0,0,0.0
NISSAN,PRIMERA,1992,3,1,33.3,2,66.7,0,0.0
NISSAN,PRIMERA,1993,2,0,0.0,2,100.0,0,0.0
NISSAN,PRIMERA,1994,3,0,0.0,3,100.0,0,0.0
NISSAN,PRIMERA,1995,8,5,62.5,3,37.5,0,0.0
NISSAN,PRIMERA,1996,24,7,29.2,17,70.8,0,0.0
NISSAN,PRIMERA,1997,33,11,33.3,22,66.7,0,0.0
NISSAN,PRIMERA,1998,43,14,32.6,29,67.4,0,0.0
NISSAN,PRIMERA,1999,57,16,28.1,41,71.9,0,0.0
NISSAN,PRIMERA,2000,64,15,23.4,49,76.6,0,0.0
NISSAN,PRIMERA,2001,55,13,23.6,42,76.4,0,0.0
NISSAN,PRIMERA,2002,341,99,29.0,242,71.0,0,0.0
NISSAN,PRIMERA,2003,358,100,27.9,258,72.1,0,0.0
NISSAN,PRIMERA,2004,568,176,31.0,392,69.0,1,0.2
NISSAN,PRIMERA,2005,1044,320,30.7,724,69.3,0,0.0
NISSAN,PRIMERA,2006,1385,487,35.2,898,64.8,1,0.1
NISSAN,PRIMERA,2007,1021,334,32.7,687,67.3,0,0.0
NISSAN,PRIMERA,2008,69,20,29.0,49,71.0,0,0.0
NISSAN,PRIMERA,2009,3,2,66.7,1,33.3,0,0.0
NISSAN,PRIMERA,2010,3,0,0.0,3,100.0,0,0.0
NISSAN,PRIMERA,2011,5,3,60.0,2,40.0,0,0.0
NISSAN,PULSAR,1990,1,0,0.0,1,100.0,0,0.0
NISSAN,PULSAR,1992,2,0,0.0,2,100.0,0,0.0
NISSAN,PULSAR,1993,4,1,25.0,3,75.0,0,0.0
NISSAN,PULSAR,1994,2,0,0.0,2,100.0,0,0.0
NISSAN,PULSAR,1995,1,1,100.0,0,0.0,0,0.0
NISSAN,PULSAR,1997,4,0,0.0,4,100.0,0,0.0
NISSAN,PULSAR,1998,12,4,33.3,8,66.7,0,0.0
NISSAN,PULSAR,1999,3,2,66.7,1,33.3,0,0.0
NISSAN,PULSAR,2000,6,1,16.7,5,83.3,0,0.0
NISSAN,PULSAR,2004,5,3,60.0,2,40.0,0,0.0
NISSAN,PULSAR,2005,11,7,63.6,4,36.4,0,0.0
NISSAN,PULSAR,2006,6,2,33.3,4,66.7,0,0.0
NISSAN,PULSAR,2007,3,1,33.3,2,66.7,0,0.0
NISSAN,PULSAR,2012,1,1,100.0,0,0.0,0,0.0
NISSAN,PULSAR,2014,109,95,87.2,14,12.8,0,0.0
NISSAN,PULSAR,2015,146,129,88.4,17,11.6,0,0.0
NISSAN,QASHQAI,2006,1,1,100.0,0,0.0,0,0.0
NISSAN,QASHQAI,2007,2465,821,33.3,1644,66.7,0,0.0
NISSAN,QASHQAI,2008,2925,965,33.0,1960,67.0,2,0.1
NISSAN,QASHQAI,2009,1534,513,33.4,1021,66.6,1,0.1
NISSAN,QASHQAI,2010,4867,2337,48.0,2530,52.0,2,0.0
NISSAN,QASHQAI,2011,805,438,54.4,367,45.6,0,0.0
NISSAN,QASHQAI,2012,3877,2670,68.9,1207,31.1,5,0.1
NISSAN,QASHQAI,2013,819,606,74.0,213,26.0,0,0.0
NISSAN,QASHQAI,2014,4730,4011,84.8,719,15.2,2,0.0
NISSAN,QASHQAI,2015,384,353,91.9,31,8.1,0,0.0
NISSAN,QASHQAI,2016,19,11,57.9,8,42.1,0,0.0
NISSAN,QASHQAI 1.5 DCI VISIA 5DR,2008,3,0,0.0,3,100.0,0,0.0
NISSAN,QASHQAI ACCENTA,2008,24,6,25.0,18,75.0,0,0.0
NISSAN,QASHQAI ACCENTA,2009,32,12,37.5,20,62.5,0,0.0
NISSAN,QASHQAI ACCENTA,2010,27,9,33.3,18,66.7,0,0.0
NISSAN,QASHQAI ACCENTA,2011,2,0,0.0,2,100.0,0,0.0
NISSAN,QASHQAI ACCENTA,2012,1,0,0.0,1,100.0,0,0.0
NISSAN,QASHQAI VISIA,2008,1,0,0.0,1,100.0,0,0.0
NISSAN,QASHQAI VISIA,2010,1,1,100.0,0,0.0,0,0.0
NISSAN,QASHQAI VISIA DCI,2008,1,1,100.0,0,0.0,0,0.0
NISSAN,SENTRA,1986,2,0,0.0,2,100.0,0,0.0
NISSAN,SENTRA,2004,1,0,0.0,1,100.0,0,0.0
NISSAN,SERENA,1994,1,1,100.0,0,0.0,0,0.0
NISSAN,SERENA,1995,2,1,50.0,1,50.0,0,0.0
NISSAN,SERENA,1996,1,0,0.0,1,100.0,0,0.0
NISSAN,SERENA,1997,1,0,0.0,1,100.0,0,0.0
NISSAN,SERENA,1998,2,0,0.0,2,100.0,0,0.0
NISSAN,SERENA,1999,5,0,0.0,5,100.0,0,0.0
NISSAN,SERENA,2000,9,1,11.1,8,88.9,0,0.0
NISSAN,SERENA,2001,5,0,0.0,5,100.0,0,0.0
NISSAN,SERENA,2002,2,1,50.0,1,50.0,0,0.0
NISSAN,SERENA,2004,1,1,100.0,0,0.0,0,0.0
NISSAN,SERENA,2005,6,3,50.0,3,50.0,0,0.0
NISSAN,SERENA,2006,12,5,41.7,7,58.3,0,0.0
NISSAN,SERENA,2007,13,5,38.5,8,61.5,0,0.0
NISSAN,SERENA,2008,3,2,66.7,1,33.3,0,0.0
NISSAN,SERENA,2009,1,0,0.0,1,100.0,0,0.0
NISSAN,SERENA,2010,1,0,0.0,1,100.0,0,0.0
NISSAN,SERENA,2012,4,4,100.0,0,0.0,0,0.0
NISSAN,SERENA,2013,6,4,66.7,2,33.3,0,0.0
NISSAN,SERENA,2014,2,2,100.0,0,0.0,0,0.0
NISSAN,SERENA,2016,2,1,50.0,1,50.0,0,0.0
NISSAN,SILVIA,1985,1,0,0.0,1,100.0,0,0.0
NISSAN,SILVIA,1989,3,0,0.0,3,100.0,0,0.0
NISSAN,SILVIA,1990,1,0,0.0,1,100.0,0,0.0
NISSAN,SILVIA,1991,10,2,20.0,8,80.0,0,0.0
NISSAN,SILVIA,1992,9,2,22.2,7,77.8,0,0.0
NISSAN,SILVIA,1993,9,3,33.3,6,66.7,0,0.0
NISSAN,SILVIA,1994,6,1,16.7,5,83.3,0,0.0
NISSAN,SILVIA,1995,17,2,11.8,15,88.2,0,0.0
NISSAN,SILVIA,1996,17,4,23.5,13,76.5,0,0.0
NISSAN,SILVIA,1997,20,1,5.0,19,95.0,0,0.0
NISSAN,SILVIA,1998,6,0,0.0,6,100.0,0,0.0
NISSAN,SILVIA,1999,39,6,15.4,33,84.6,0,0.0
NISSAN,SILVIA,2000,15,2,13.3,13,86.7,0,0.0
NISSAN,SILVIA,2001,8,4,50.0,4,50.0,0,0.0
NISSAN,SILVIA,2002,9,1,11.1,8,88.9,0,0.0
NISSAN,SILVIA,2003,1,0,0.0,1,100.0,0,0.0
NISSAN,SKYLINE,1990,2,1,50.0,1,50.0,0,0.0
NISSAN,SKYLINE,1991,8,6,75.0,2,25.0,0,0.0
NISSAN,SKYLINE,1992,18,7,38.9,11,61.1,0,0.0
NISSAN,SKYLINE,1993,17,6,35.3,11,64.7,0,0.0
NISSAN,SKYLINE,1994,7,3,42.9,4,57.1,0,0.0
NISSAN,SKYLINE,1995,9,3,33.3,6,66.7,0,0.0
NISSAN,SKYLINE,1996,23,4,17.4,19,82.6,0,0.0
NISSAN,SKYLINE,1997,12,3,25.0,9,75.0,0,0.0
NISSAN,SKYLINE,1998,15,2,13.3,13,86.7,0,0.0
NISSAN,SKYLINE,1999,13,6,46.2,7,53.8,0,0.0
NISSAN,SKYLINE,2000,7,3,42.9,4,57.1,0,0.0
NISSAN,SKYLINE,2001,1,0,0.0,1,100.0,0,0.0
NISSAN,SKYLINE,2002,1,0,0.0,1,100.0,0,0.0
NISSAN,SKYLINE,2003,1,1,100.0,0,0.0,0,0.0
NISSAN,SKYLINE,2004,1,0,0.0,1,100.0,0,0.0
NISSAN,SKYLINE,2005,1,1,100.0,0,0.0,0,0.0
NISSAN,SKYLINE,2008,1,1,100.0,0,0.0,0,0.0
NISSAN,SKYLINE,2014,1,0,0.0,1,100.0,0,0.0
NISSAN,STAGEA,1998,1,0,0.0,1,100.0,0,0.0
NISSAN,SUNNY,1987,1,0,0.0,1,100.0,0,0.0
NISSAN,SUNNY,1988,2,0,0.0,2,100.0,0,0.0
NISSAN,SUNNY,1990,7,2,28.6,5,71.4,0,0.0
NISSAN,SUNNY,1991,12,2,16.7,10,83.3,0,0.0
NISSAN,SUNNY,1992,5,1,20.0,4,80.0,0,0.0
NISSAN,SUNNY,1993,14,0,0.0,14,100.0,0,0.0
NISSAN,SUNNY,1994,35,7,20.0,28,80.0,0,0.0
NISSAN,SUNNY,1995,34,9,26.5,25,73.5,0,0.0
NISSAN,SUNNY,1996,2,0,0.0,2,100.0,0,0.0
NISSAN,SUNNY,1998,1,1,100.0,0,0.0,0,0.0
NISSAN,SUNNY,1999,1,1,100.0,0,0.0,0,0.0
NISSAN,SUNNY,2000,1,1,100.0,0,0.0,0,0.0
NISSAN,SUNNY,2001,2,0,0.0,2,100.0,0,0.0
NISSAN,SUNNY,2003,2,1,50.0,1,50.0,0,0.0
NISSAN,SUNNY,2004,3,1,33.3,2,66.7,0,0.0
NISSAN,TEANA,2004,2,0,0.0,2,100.0,0,0.0
NISSAN,TEANA,2005,2,0,0.0,2,100.0,0,0.0
NISSAN,TEANA,2006,2,0,0.0,2,100.0,0,0.0
NISSAN,TEANA,2008,1,1,100.0,0,0.0,0,0.0
NISSAN,TERRANO,1996,1,0,0.0,1,100.0,0,0.0
NISSAN,TERRANO,1997,1,0,0.0,1,100.0,0,0.0
NISSAN,TERRANO,1999,1,0,0.0,1,100.0,0,0.0
NISSAN,TERRANO,2000,2,0,0.0,2,100.0,0,0.0
NISSAN,TERRANO,2001,4,0,0.0,4,100.0,0,0.0
NISSAN,TERRANO,2002,4,2,50.0,2,50.0,0,0.0
NISSAN,TERRANO,2003,6,0,0.0,6,100.0,0,0.0
NISSAN,TERRANO,2004,15,5,33.3,10,66.7,0,0.0
NISSAN,TERRANO,2005,8,2,25.0,6,75.0,0,0.0
NISSAN,TIIDA,2004,1,0,0.0,1,100.0,0,0.0
NISSAN,TIIDA,2005,8,4,50.0,4,50.0,0,0.0
NISSAN,TIIDA,2006,2,2,100.0,0,0.0,0,0.0
NISSAN,TIIDA,2007,1033,478,46.3,555,53.7,1,0.1
NISSAN,TIIDA,2008,979,386,39.4,593,60.6,0,0.0
NISSAN,TIIDA,2009,331,144,43.5,187,56.5,1,0.3
NISSAN,TIIDA,2010,359,171,47.6,188,52.4,0,0.0
NISSAN,TIIDA,2011,46,28,60.9,18,39.1,0,0.0
NISSAN,TIIDA,2016,3,2,66.7,1,33.3,0,0.0
NISSAN,TIIDA 1.5 5DR A,2004,1,0,0.0,1,100.0,0,0.0
NISSAN,TIIDA 1.5 5DR A,2005,1,1,100.0,0,0.0,0,0.0
NISSAN,TIIDA 1.5 5DR A,2007,1,1,100.0,0,0.0,0,0.0
NISSAN,TINO,2001,2,0,0.0,2,100.0,0,0.0
NISSAN,TINO,2002,20,8,40.0,12,60.0,0,0.0
NISSAN,TINO,2003,31,4,12.9,27,87.1,0,0.0
NISSAN,TINO,2004,98,33,33.7,65,66.3,0,0.0
NISSAN,TINO,2005,136,46,33.8,90,66.2,0,0.0
NISSAN,TINO,2006,73,32,43.8,41,56.2,0,0.0
NISSAN,WINGROAD,2006,1,1,100.0,0,0.0,0,0.0
NISSAN,X-TRAIL,2001,1,0,0.0,1,100.0,0,0.0
NISSAN,X-TRAIL,2002,30,12,40.0,18,60.0,0,0.0
NISSAN,X-TRAIL,2003,119,35,29.4,84,70.6,0,0.0
NISSAN,X-TRAIL,2004,250,82,32.8,168,67.2,0,0.0
NISSAN,X-TRAIL,2005,427,171,40.0,256,60.0,0,0.0
NISSAN,X-TRAIL,2006,466,173,37.1,293,62.9,2,0.4
NISSAN,X-TRAIL,2007,254,86,33.9,168,66.1,0,0.0
NISSAN,X-TRAIL,2008,192,76,39.6,116,60.4,0,0.0
NISSAN,X-TRAIL,2009,96,34,35.4,62,64.6,0,0.0
NISSAN,X-TRAIL,2010,18,8,44.4,10,55.6,0,0.0
NISSAN,X-TRAIL,2011,4,2,50.0,2,50.0,0,0.0
NISSAN,X-TRAIL,2012,93,59,63.4,34,36.6,0,0.0
NISSAN,X-TRAIL,2013,8,7,87.5,1,12.5,0,0.0
NISSAN,X-TRAIL,2014,284,240,84.5,44,15.5,0,0.0
NISSAN,X-TRAIL,2015,40,31,77.5,9,22.5,0,0.0
NISSAN,X-TRAIL,2016,1,1,100.0,0,0.0,0,0.0
NISSAN,X-TRAIL,2017,1,1,100.0,0,0.0,0,0.0
OPEL,ADAM,2013,3,3,100.0,0,0.0,0,0.0
OPEL,ADAM,2014,87,80,92.0,7,8.0,0,0.0
OPEL,ADAM,2015,10,10,100.0,0,0.0,0,0.0
OPEL,AGILA,2000,32,8,25.0,24,75.0,0,0.0
OPEL,AGILA,2001,62,26,41.9,36,58.1,0,0.0
OPEL,AGILA,2002,110,45,40.9,65,59.1,0,0.0
OPEL,AGILA,2003,20,9,45.0,11,55.0,0,0.0
OPEL,AGILA,2004,2,1,50.0,1,50.0,0,0.0
OPEL,AGILA,2005,71,32,45.1,39,54.9,0,0.0
OPEL,AGILA,2006,66,29,43.9,37,56.1,0,0.0
OPEL,AGILA,2007,38,17,44.7,21,55.3,0,0.0
OPEL,AGILA,2008,60,32,53.3,28,46.7,0,0.0
OPEL,AGILA,2009,17,8,47.1,9,52.9,0,0.0
OPEL,AGILA,2010,32,24,75.0,8,25.0,0,0.0
OPEL,AGILA,2011,5,4,80.0,1,20.0,0,0.0
OPEL,AGILA,2012,18,14,77.8,4,22.2,0,0.0
OPEL,AGILA,2013,2,2,100.0,0,0.0,0,0.0
OPEL,ANTARA,2007,17,2,11.8,15,88.2,0,0.0
OPEL,ANTARA,2008,186,68,36.6,118,63.4,1,0.5
OPEL,ANTARA,2009,9,4,44.4,5,55.6,0,0.0
OPEL,ANTARA,2010,19,7,36.8,12,63.2,0,0.0
OPEL,ANTARA,2011,2,2,100.0,0,0.0,0,0.0
OPEL,ASCONA,1980,1,1,100.0,0,0.0,0,0.0
OPEL,ASCONA,1983,1,1,100.0,0,0.0,0,0.0
OPEL,ASCONA,1984,1,1,100.0,0,0.0,0,0.0
OPEL,ASCONA,1987,1,0,0.0,1,100.0,0,0.0
OPEL,ASTRA,1992,6,3,50.0,3,50.0,0,0.0
OPEL,ASTRA,1993,15,3,20.0,12,80.0,0,0.0
OPEL,ASTRA,1994,25,11,44.0,14,56.0,0,0.0
OPEL,ASTRA,1995,44,17,38.6,27,61.4,0,0.0
OPEL,ASTRA,1996,69,25,36.2,44,63.8,0,0.0
OPEL,ASTRA,1997,138,60,43.5,78,56.5,0,0.0
OPEL,ASTRA,1998,182,58,31.9,124,68.1,0,0.0
OPEL,ASTRA,1999,452,150,33.2,302,66.8,0,0.0
OPEL,ASTRA,2000,959,323,33.7,636,66.3,0,0.0
OPEL,ASTRA,2001,938,324,34.5,614,65.5,0,0.0
OPEL,ASTRA,2002,1381,516,37.4,865,62.6,1,0.1
OPEL,ASTRA,2003,1489,519,34.9,970,65.1,2,0.1
OPEL,ASTRA,2004,1826,729,39.9,1097,60.1,0,0.0
OPEL,ASTRA,2005,3230,1300,40.2,1930,59.8,0,0.0
OPEL,ASTRA,2006,4604,1988,43.2,2616,56.8,2,0.0
OPEL,ASTRA,2007,4881,2122,43.5,2759,56.5,0,0.0
OPEL,ASTRA,2008,2399,1077,44.9,1322,55.1,0,0.0
OPEL,ASTRA,2009,384,200,52.1,184,47.9,0,0.0
OPEL,ASTRA,2010,1852,1226,66.2,626,33.8,0,0.0
OPEL,ASTRA,2011,273,176,64.5,97,35.5,0,0.0
OPEL,ASTRA,2012,1276,868,68.0,408,32.0,0,0.0
OPEL,ASTRA,2013,172,130,75.6,42,24.4,0,0.0
OPEL,ASTRA,2014,1477,1250,84.6,227,15.4,0,0.0
OPEL,ASTRA,2015,165,140,84.8,25,15.2,0,0.0
OPEL,CALIBRA,1992,1,0,0.0,1,100.0,0,0.0
OPEL,CALIBRA,1993,2,1,50.0,1,50.0,0,0.0
OPEL,CALIBRA,1996,2,1,50.0,1,50.0,0,0.0
OPEL,COMBO,2001,1,0,0.0,1,100.0,0,0.0
OPEL,CORSA,1984,2,0,0.0,2,100.0,0,0.0
OPEL,CORSA,1986,2,0,0.0,2,100.0,0,0.0
OPEL,CORSA,1988,5,2,40.0,3,60.0,0,0.0
OPEL,CORSA,1989,4,2,50.0,2,50.0,0,0.0
OPEL,CORSA,1990,1,0,0.0,1,100.0,0,0.0
OPEL,CORSA,1991,4,3,75.0,1,25.0,0,0.0
OPEL,CORSA,1992,2,0,0.0,2,100.0,0,0.0
OPEL,CORSA,1993,6,1,16.7,5,83.3,0,0.0
OPEL,CORSA,1994,11,4,36.4,7,63.6,0,0.0
OPEL,CORSA,1995,18,10,55.6,8,44.4,0,0.0
OPEL,CORSA,1996,57,29,50.9,28,49.1,0,0.0
OPEL,CORSA,1997,144,66,45.8,78,54.2,0,0.0
OPEL,CORSA,1998,136,44,32.4,92,67.6,0,0.0
OPEL,CORSA,1999,207,62,30.0,145,70.0,0,0.0
OPEL,CORSA,2000,474,138,29.1,336,70.9,0,0.0
OPEL,CORSA,2001,927,278,30.0,649,70.0,0,0.0
OPEL,CORSA,2002,1176,359,30.5,817,69.5,0,0.0
OPEL,CORSA,2003,1108,355,32.0,753,68.0,0,0.0
OPEL,CORSA,2004,1368,420,30.7,948,69.3,0,0.0
OPEL,CORSA,2005,1573,548,34.8,1025,65.2,0,0.0
OPEL,CORSA,2006,1693,668,39.5,1025,60.5,2,0.1
OPEL,CORSA,2007,3978,1788,44.9,2190,55.1,2,0.1
OPEL,CORSA,2008,1861,938,50.4,923,49.6,2,0.1
OPEL,CORSA,2009,436,232,53.2,204,46.8,0,0.0
OPEL,CORSA,2010,1394,875,62.8,519,37.2,0,0.0
OPEL,CORSA,2011,194,136,70.1,58,29.9,0,0.0
OPEL,CORSA,2012,1029,789,76.7,240,23.3,0,0.0
OPEL,CORSA,2013,97,70,72.2,27,27.8,0,0.0
OPEL,CORSA,2014,1058,835,78.9,223,21.1,0,0.0
OPEL,CORSA,2015,120,105,87.5,15,12.5,0,0.0
OPEL,FRONTERA,1994,1,0,0.0,1,100.0,0,0.0
OPEL,FRONTERA,1995,1,0,0.0,1,100.0,0,0.0
OPEL,FRONTERA,1999,3,1,33.3,2,66.7,0,0.0
OPEL,FRONTERA,2000,8,2,25.0,6,75.0,0,0.0
OPEL,FRONTERA,2001,1,1,100.0,0,0.0,0,0.0
OPEL,FRONTERA,2002,4,3,75.0,1,25.0,0,0.0
OPEL,FRONTERA,2003,1,0,0.0,1,100.0,0,0.0
OPEL,INSIGNIA,2008,9,4,44.4,5,55.6,0,0.0
OPEL,INSIGNIA,2009,497,253,50.9,244,49.1,0,0.0
OPEL,INSIGNIA,2010,1841,1018,55.3,823,44.7,0,0.0
OPEL,INSIGNIA,2011,271,150,55.4,121,44.6,0,0.0
OPEL,INSIGNIA,2012,1441,1014,70.4,427,29.6,0,0.0
OPEL,INSIGNIA,2013,152,117,77.0,35,23.0,0,0.0
OPEL,INSIGNIA,2014,1595,1265,79.3,330,20.7,0,0.0
OPEL,INSIGNIA,2015,133,105,78.9,28,21.1,0,0.0
OPEL,INSIGNIA,2016,5,5,100.0,0,0.0,0,0.0
OPEL,INSIGNIA,2017,2,2,100.0,0,0.0,0,0.0
OPEL,KADETT,1980,2,2,100.0,0,0.0,0,0.0
OPEL,KADETT,1981,3,0,0.0,3,100.0,0,0.0
OPEL,KADETT,1983,5,4,80.0,1,20.0,0,0.0
OPEL,KADETT,1984,3,1,33.3,2,66.7,0,0.0
OPEL,KADETT,1985,1,1,100.0,0,0.0,0,0.0
OPEL,KADETT,1987,1,1,100.0,0,0.0,0,0.0
OPEL,KADETT,1989,3,1,33.3,2,66.7,0,0.0
OPEL,KADETT,1990,4,0,0.0,4,100.0,0,0.0
OPEL,KADETT,1991,9,2,22.2,7,77.8,0,0.0
OPEL,KADETT,1992,1,0,0.0,1,100.0,0,0.0
OPEL,MANTA,1983,2,0,0.0,2,100.0,0,0.0
OPEL,MANTA,1984,5,1,20.0,4,80.0,0,0.0
OPEL,MANTA,1985,4,3,75.0,1,25.0,0,0.0
OPEL,MANTA,1986,1,1,100.0,0,0.0,0,0.0
OPEL,MANTA,1987,1,0,0.0,1,100.0,0,0.0
OPEL,MANTA,1988,5,3,60.0,2,40.0,0,0.0
OPEL,MERIVA,2003,86,32,37.2,54,62.8,0,0.0
OPEL,MERIVA,2004,299,78,26.1,221,73.9,0,0.0
OPEL,MERIVA,2005,408,120,29.4,288,70.6,0,0.0
OPEL,MERIVA,2006,389,125,32.1,264,67.9,0,0.0
OPEL,MERIVA,2007,413,126,30.5,287,69.5,0,0.0
OPEL,MERIVA,2008,149,66,44.3,83,55.7,0,0.0
OPEL,MERIVA,2009,42,20,47.6,22,52.4,0,0.0
OPEL,MERIVA,2010,97,63,64.9,34,35.1,0,0.0
OPEL,MERIVA,2011,39,24,61.5,15,38.5,0,0.0
OPEL,MERIVA,2012,103,81,78.6,22,21.4,0,0.0
OPEL,MERIVA,2013,5,4,80.0,1,20.0,0,0.0
OPEL,MERIVA,2014,62,54,87.1,8,12.9,0,0.0
OPEL,MERIVA,2015,10,9,90.0,1,10.0,0,0.0
OPEL,MOKKA,2012,6,6,100.0,0,0.0,0,0.0
OPEL,MOKKA,2013,49,42,85.7,7,14.3,0,0.0
OPEL,MOKKA,2014,768,666,86.7,102,13.3,0,0.0
OPEL,MOKKA,2015,97,84,86.6,13,13.4,0,0.0
OPEL,MONZA,1983,1,1,100.0,0,0.0,0,0.0
OPEL,MONZA,1985,1,1,100.0,0,0.0,0,0.0
OPEL,MONZA,1986,2,1,50.0,1,50.0,0,0.0
OPEL,MOVANO,2006,1,0,0.0,1,100.0,0,0.0
OPEL,MOVANO,2014,1,1,100.0,0,0.0,0,0.0
OPEL,OMEGA,1988,1,0,0.0,1,100.0,0,0.0
OPEL,OMEGA,1992,1,0,0.0,1,100.0,0,0.0
OPEL,OMEGA,1993,1,0,0.0,1,100.0,0,0.0
OPEL,OMEGA,1994,1,0,0.0,1,100.0,0,0.0
OPEL,OMEGA,1998,5,1,20.0,4,80.0,0,0.0
OPEL,OMEGA,1999,5,3,60.0,2,40.0,0,0.0
OPEL,OMEGA,2000,15,2,13.3,13,86.7,0,0.0
OPEL,OMEGA,2001,10,5,50.0,5,50.0,0,0.0
OPEL,OMEGA,2002,7,4,57.1,3,42.9,0,0.0
OPEL,OMEGA,2003,8,3,37.5,5,62.5,0,0.0
OPEL,OTHER,1981,1,0,0.0,1,100.0,0,0.0
OPEL,OTHER,1985,1,0,0.0,1,100.0,0,0.0
OPEL,OTHER,1988,1,1,100.0,0,0.0,0,0.0
OPEL,OTHER,1997,1,1,100.0,0,0.0,0,0.0
OPEL,OTHER,2000,21,7,33.3,14,66.7,0,0.0
OPEL,OTHER,2001,1,0,0.0,1,100.0,0,0.0
OPEL,OTHER,2002,3,1,33.3,2,66.7,0,0.0
OPEL,OTHER,2003,4,0,0.0,4,100.0,0,0.0
OPEL,OTHER,2004,15,4,26.7,11,73.3,0,0.0
OPEL,OTHER,2005,22,7,31.8,15,68.2,0,0.0
OPEL,OTHER,2006,7,1,14.3,6,85.7,0,0.0
OPEL,OTHER,2007,3,0,0.0,3,100.0,0,0.0
OPEL,OTHER,2008,3,0,0.0,3,100.0,0,0.0
OPEL,OTHER,2010,1,0,0.0,1,100.0,0,0.0
OPEL,SENATOR,1983,1,0,0.0,1,100.0,0,0.0
OPEL,SIGNUM,2003,7,3,42.9,4,57.1,0,0.0
OPEL,SIGNUM,2004,11,4,36.4,7,63.6,0,0.0
OPEL,SIGNUM,2005,8,1,12.5,7,87.5,0,0.0
OPEL,SIGNUM,2006,5,1,20.0,4,80.0,0,0.0
OPEL,SIGNUM,2007,1,1,100.0,0,0.0,0,0.0
OPEL,SPEEDSTER,2005,1,1,100.0,0,0.0,0,0.0
OPEL,TIGRA,1996,1,1,100.0,0,0.0,0,0.0
OPEL,TIGRA,1998,5,3,60.0,2,40.0,0,0.0
OPEL,TIGRA,1999,2,1,50.0,1,50.0,0,0.0
OPEL,TIGRA,2000,24,5,20.8,19,79.2,0,0.0
OPEL,TIGRA,2004,14,3,21.4,11,78.6,0,0.0
OPEL,TIGRA,2005,149,52,34.9,97,65.1,0,0.0
OPEL,TIGRA,2006,95,42,44.2,53,55.8,0,0.0
OPEL,TIGRA,2007,76,31,40.8,45,59.2,0,0.0
OPEL,TIGRA,2008,26,12,46.2,14,53.8,0,0.0
OPEL,TIGRA,2009,4,1,25.0,3,75.0,0,0.0
OPEL,TIGRA,2010,9,6,66.7,3,33.3,0,0.0
OPEL,TIGRA,2011,6,4,66.7,2,33.3,0,0.0
OPEL,VECTRA,1991,1,1,100.0,0,0.0,0,0.0
OPEL,VECTRA,1992,2,0,0.0,2,100.0,0,0.0
OPEL,VECTRA,1993,6,1,16.7,5,83.3,0,0.0
OPEL,VECTRA,1994,7,1,14.3,6,85.7,0,0.0
OPEL,VECTRA,1995,16,6,37.5,10,62.5,0,0.0
OPEL,VECTRA,1996,9,2,22.2,7,77.8,0,0.0
OPEL,VECTRA,1997,14,1,7.1,13,92.9,0,0.0
OPEL,VECTRA,1998,12,4,33.3,8,66.7,0,0.0
OPEL,VECTRA,1999,37,12,32.4,25,67.6,0,0.0
OPEL,VECTRA,2000,102,34,33.3,68,66.7,0,0.0
OPEL,VECTRA,2001,59,21,35.6,38,64.4,0,0.0
OPEL,VECTRA,2002,62,16,25.8,46,74.2,0,0.0
OPEL,VECTRA,2003,250,69,27.6,181,72.4,0,0.0
OPEL,VECTRA,2004,465,130,28.0,335,72.0,0,0.0
OPEL,VECTRA,2005,842,238,28.3,604,71.7,1,0.1
OPEL,VECTRA,2006,1072,347,32.4,725,67.6,1,0.1
OPEL,VECTRA,2007,1185,439,37.0,746,63.0,3,0.3
OPEL,VECTRA,2008,527,176,33.4,351,66.6,0,0.0
OPEL,VECTRA,2009,58,24,41.4,34,58.6,0,0.0
OPEL,VECTRA,2010,51,21,41.2,30,58.8,0,0.0
OPEL,VIVARO,2004,2,2,100.0,0,0.0,0,0.0
OPEL,VIVARO,2006,17,4,23.5,13,76.5,0,0.0
OPEL,VIVARO,2007,17,2,11.8,15,88.2,0,0.0
OPEL,VIVARO,2008,12,2,16.7,10,83.3,0,0.0
OPEL,VIVARO,2009,2,1,50.0,1,50.0,0,0.0
OPEL,VIVARO,2011,5,4,80.0,1,20.0,0,0.0
OPEL,VIVARO,2012,6,3,50.0,3,50.0,0,0.0
OPEL,VIVARO,2013,15,5,33.3,10,66.7,0,0.0
OPEL,VIVARO,2014,9,3,33.3,6,66.7,0,0.0
OPEL,VIVARO,2015,14,6,42.9,8,57.1,0,0.0
OPEL,VIVARO,2016,19,10,52.6,9,47.4,2,10.5
OPEL,VIVARO,2017,8,7,87.5,1,12.5,0,0.0
OPEL,VIVARO,2018,2,1,50.0,1,50.0,0,0.0
OPEL,ZAFIRA,1999,6,3,50.0,3,50.0,0,0.0
OPEL,ZAFIRA,2000,61,25,41.0,36,59.0,0,0.0
OPEL,ZAFIRA,2001,132,33,25.0,99,75.0,0,0.0
OPEL,ZAFIRA,2002,322,90,28.0,232,72.0,0,0.0
OPEL,ZAFIRA,2003,502,126,25.1,376,74.9,0,0.0
OPEL,ZAFIRA,2004,976,256,26.2,720,73.8,0,0.0
OPEL,ZAFIRA,2005,912,257,28.2,655,71.8,0,0.0
OPEL,ZAFIRA,2006,1861,596,32.0,1265,68.0,0,0.0
OPEL,ZAFIRA,2007,1726,551,31.9,1175,68.1,1,0.1
OPEL,ZAFIRA,2008,826,273,33.1,553,66.9,0,0.0
OPEL,ZAFIRA,2009,67,19,28.4,48,71.6,0,0.0
OPEL,ZAFIRA,2010,318,155,48.7,163,51.3,0,0.0
OPEL,ZAFIRA,2011,30,12,40.0,18,60.0,0,0.0
OPEL,ZAFIRA,2012,303,199,65.7,104,34.3,0,0.0
OPEL,ZAFIRA,2013,20,16,80.0,4,20.0,0,0.0
OPEL,ZAFIRA,2014,242,176,72.7,66,27.3,1,0.4
OPEL,ZAFIRA,2015,14,8,57.1,6,42.9,0,0.0
PANTHER,OTHER,1988,1,1,100.0,0,0.0,0,0.0
PERODUA,KELISA,2005,1,1,100.0,0,0.0,0,0.0
PERODUA,KELISA,2006,1,0,0.0,1,100.0,0,0.0
PERODUA,KELISA EX 05 DR,2006,1,0,0.0,1,100.0,0,0.0
PERODUA,KELISA EX 05 DR,2009,1,1,100.0,0,0.0,0,0.0
PERODUA,MYVI,2008,1,0,0.0,1,100.0,0,0.0
PERODUA,MYVI,2010,4,3,75.0,1,25.0,0,0.0
PERODUA,MYVI,2012,2,2,100.0,0,0.0,0,0.0
PERODUA,MYVI,2013,1,1,100.0,0,0.0,0,0.0
PERODUA,MYVI,2014,2,1,50.0,1,50.0,0,0.0
PERODUA,OTHER,2007,13,7,53.8,6,46.2,0,0.0
PERODUA,OTHER,2008,4,2,50.0,2,50.0,0,0.0
PERODUA,OTHER,2009,13,5,38.5,8,61.5,0,0.0
PERODUA,OTHER,2010,11,6,54.5,5,45.5,0,0.0
PERODUA,OTHER,2011,1,1,100.0,0,0.0,0,0.0
PERODUA,OTHER,2012,6,4,66.7,2,33.3,0,0.0
PERODUA,OTHER,2013,1,1,100.0,0,0.0,0,0.0
PERODUA,OTHER,2014,4,4,100.0,0,0.0,0,0.0
PERODUA,OTHER,2015,1,1,100.0,0,0.0,0,0.0
PEUGEOT,1007,2005,26,9,34.6,17,65.4,0,0.0
PEUGEOT,1007,2006,34,16,47.1,18,52.9,0,0.0
PEUGEOT,1007,2007,6,2,33.3,4,66.7,0,0.0
PEUGEOT,1007,2009,2,1,50.0,1,50.0,0,0.0
PEUGEOT,106,1992,4,2,50.0,2,50.0,0,0.0
PEUGEOT,106,1993,1,0,0.0,1,100.0,0,0.0
PEUGEOT,106,1994,8,0,0.0,8,100.0,0,0.0
PEUGEOT,106,1995,4,0,0.0,4,100.0,0,0.0
PEUGEOT,106,1996,21,12,57.1,9,42.9,0,0.0
PEUGEOT,106,1997,37,14,37.8,23,62.2,0,0.0
PEUGEOT,106,1998,46,19,41.3,27,58.7,1,2.2
PEUGEOT,106,1999,31,6,19.4,25,80.6,0,0.0
PEUGEOT,106,2000,33,12,36.4,21,63.6,0,0.0
PEUGEOT,106,2001,35,12,34.3,23,65.7,0,0.0
PEUGEOT,106,2002,42,15,35.7,27,64.3,0,0.0
PEUGEOT,106,2003,29,11,37.9,18,62.1,0,0.0
PEUGEOT,107,2005,8,3,37.5,5,62.5,0,0.0
PEUGEOT,107,2006,312,159,51.0,153,49.0,0,0.0
PEUGEOT,107,2007,231,126,54.5,105,45.5,0,0.0
PEUGEOT,107,2008,91,51,56.0,40,44.0,0,0.0
PEUGEOT,107,2009,30,14,46.7,16,53.3,0,0.0
PEUGEOT,107,2010,77,49,63.6,28,36.4,0,0.0
PEUGEOT,107,2011,23,14,60.9,9,39.1,0,0.0
PEUGEOT,107,2012,49,36,73.5,13,26.5,0,0.0
PEUGEOT,107,2013,15,7,46.7,8,53.3,0,0.0
PEUGEOT,107,2014,22,19,86.4,3,13.6,0,0.0
PEUGEOT,108,2014,3,2,66.7,1,33.3,0,0.0
PEUGEOT,108,2015,5,3,60.0,2,40.0,0,0.0
PEUGEOT,2008,2013,8,4,50.0,4,50.0,0,0.0
PEUGEOT,2008,2014,606,500,82.5,106,17.5,0,0.0
PEUGEOT,2008,2015,88,73,83.0,15,17.0,0,0.0
PEUGEOT,205,1986,1,0,0.0,1,100.0,0,0.0
PEUGEOT,205,1987,3,0,0.0,3,100.0,0,0.0
PEUGEOT,205,1988,8,3,37.5,5,62.5,0,0.0
PEUGEOT,205,1989,13,7,53.8,6,46.2,0,0.0
PEUGEOT,205,1990,19,9,47.4,10,52.6,0,0.0
PEUGEOT,205,1991,13,6,46.2,7,53.8,0,0.0
PEUGEOT,205,1992,3,1,33.3,2,66.7,0,0.0
PEUGEOT,205,1993,6,0,0.0,6,100.0,0,0.0
PEUGEOT,205,1994,5,3,60.0,2,40.0,0,0.0
PEUGEOT,205,1995,1,0,0.0,1,100.0,0,0.0
PEUGEOT,205,1996,3,1,33.3,2,66.7,0,0.0
PEUGEOT,206,1998,4,2,50.0,2,50.0,0,0.0
PEUGEOT,206,1999,146,37,25.3,109,74.7,0,0.0
PEUGEOT,206,2000,369,92,24.9,277,75.1,0,0.0
PEUGEOT,206,2001,736,191,26.0,545,74.0,0,0.0
PEUGEOT,206,2002,1209,289,23.9,920,76.1,0,0.0
PEUGEOT,206,2003,1777,443,24.9,1334,75.1,0,0.0
PEUGEOT,206,2004,2505,846,33.8,1659,66.2,0,0.0
PEUGEOT,206,2005,2473,907,36.7,1566,63.3,1,0.0
PEUGEOT,206,2006,1831,724,39.5,1107,60.5,1,0.1
PEUGEOT,206,2007,133,58,43.6,75,56.4,0,0.0
PEUGEOT,206,2008,10,2,20.0,8,80.0,0,0.0
PEUGEOT,206,2009,10,1,10.0,9,90.0,0,0.0
PEUGEOT,206,2012,1,0,0.0,1,100.0,0,0.0
PEUGEOT,206 1.1 L 5DR,2000,1,0,0.0,1,100.0,0,0.0
PEUGEOT,207,2006,656,275,41.9,381,58.1,0,0.0
PEUGEOT,207,2007,3334,1465,43.9,1869,56.1,1,0.0
PEUGEOT,207,2008,1670,659,39.5,1011,60.5,1,0.1
PEUGEOT,207,2009,605,256,42.3,349,57.7,0,0.0
PEUGEOT,207,2010,1087,582,53.5,505,46.5,0,0.0
PEUGEOT,207,2011,232,132,56.9,100,43.1,0,0.0
PEUGEOT,207,2012,458,298,65.1,160,34.9,0,0.0
PEUGEOT,207,2013,7,5,71.4,2,28.6,0,0.0
PEUGEOT,207,2014,1,0,0.0,1,100.0,0,0.0
PEUGEOT,207,2016,1,0,0.0,1,100.0,0,0.0
PEUGEOT,208,2012,159,123,77.4,36,22.6,0,0.0
PEUGEOT,208,2013,234,187,79.9,47,20.1,0,0.0
PEUGEOT,208,2014,713,580,81.3,133,18.7,0,0.0
PEUGEOT,208,2015,91,79,86.8,12,13.2,0,0.0
PEUGEOT,208,2016,1,1,100.0,0,0.0,0,0.0
PEUGEOT,3008,2009,10,2,20.0,8,80.0,0,0.0
PEUGEOT,3008,2010,1287,608,47.2,679,52.8,0,0.0
PEUGEOT,3008,2011,220,128,58.2,92,41.8,0,0.0
PEUGEOT,3008,2012,728,500,68.7,228,31.3,0,0.0
PEUGEOT,3008,2013,141,87,61.7,54,38.3,0,0.0
PEUGEOT,3008,2014,535,418,78.1,117,21.9,0,0.0
PEUGEOT,3008,2015,47,36,76.6,11,23.4,0,0.0
PEUGEOT,3008,2016,6,4,66.7,2,33.3,0,0.0
PEUGEOT,3008,2017,1,1,100.0,0,0.0,0,0.0
PEUGEOT,304,2002,2,0,0.0,2,100.0,0,0.0
PEUGEOT,305,1983,2,1,50.0,1,50.0,0,0.0
PEUGEOT,306,1994,7,5,71.4,2,28.6,0,0.0
PEUGEOT,306,1995,8,3,37.5,5,62.5,0,0.0
PEUGEOT,306,1996,12,4,33.3,8,66.7,0,0.0
PEUGEOT,306,1997,21,9,42.9,12,57.1,0,0.0
PEUGEOT,306,1998,34,11,32.4,23,67.6,0,0.0
PEUGEOT,306,1999,48,15,31.3,33,68.8,0,0.0
PEUGEOT,306,2000,91,32,35.2,59,64.8,0,0.0
PEUGEOT,306,2001,55,19,34.5,36,65.5,0,0.0
PEUGEOT,306,2002,1,0,0.0,1,100.0,0,0.0
PEUGEOT,307,2001,59,19,32.2,40,67.8,0,0.0
PEUGEOT,307,2002,710,195,27.5,515,72.5,0,0.0
PEUGEOT,307,2003,997,279,28.0,718,72.0,0,0.0
PEUGEOT,307,2004,1661,532,32.0,1129,68.0,0,0.0
PEUGEOT,307,2005,1853,600,32.4,1253,67.6,2,0.1
PEUGEOT,307,2006,1684,587,34.9,1097,65.1,2,0.1
PEUGEOT,307,2007,1262,492,39.0,770,61.0,1,0.1
PEUGEOT,307,2008,388,132,34.0,256,66.0,0,0.0
PEUGEOT,307,2009,6,3,50.0,3,50.0,0,0.0
PEUGEOT,307,2010,1,0,0.0,1,100.0,0,0.0
PEUGEOT,307,2011,1,1,100.0,0,0.0,0,0.0
PEUGEOT,307 1.4 S 5DR,2003,1,0,0.0,1,100.0,0,0.0
PEUGEOT,307 1.6 S 5DR,2006,2,1,50.0,1,50.0,0,0.0
PEUGEOT,307 1.6 SW S 5SEATS,2004,1,1,100.0,0,0.0,0,0.0
PEUGEOT,308,2007,29,12,41.4,17,58.6,0,0.0
PEUGEOT,308,2008,1745,725,41.5,1020,58.5,1,0.1
PEUGEOT,308,2009,732,312,42.6,420,57.4,0,0.0
PEUGEOT,308,2010,1422,726,51.1,696,48.9,0,0.0
PEUGEOT,308,2011,233,151,64.8,82,35.2,0,0.0
PEUGEOT,308,2012,834,610,73.1,224,26.9,0,0.0
PEUGEOT,308,2013,146,120,82.2,26,17.8,0,0.0
PEUGEOT,308,2014,775,630,81.3,145,18.7,0,0.0
PEUGEOT,308,2015,79,67,84.8,12,15.2,0,0.0
PEUGEOT,308,2016,7,5,71.4,2,28.6,0,0.0
PEUGEOT,309,1986,2,1,50.0,1,50.0,0,0.0
PEUGEOT,309,1989,1,0,0.0,1,100.0,0,0.0
PEUGEOT,309,1990,1,0,0.0,1,100.0,0,0.0
PEUGEOT,4007,2008,16,5,31.3,11,68.8,0,0.0
PEUGEOT,4007,2010,2,1,50.0,1,50.0,0,0.0
PEUGEOT,405,1988,1,0,0.0,1,100.0,0,0.0
PEUGEOT,405,1991,1,0,0.0,1,100.0,0,0.0
PEUGEOT,405,1992,1,0,0.0,1,100.0,0,0.0
PEUGEOT,405,1993,5,2,40.0,3,60.0,0,0.0
PEUGEOT,405,1994,3,0,0.0,3,100.0,0,0.0
PEUGEOT,405,1995,13,4,30.8,9,69.2,0,0.0
PEUGEOT,405,1996,2,1,50.0,1,50.0,0,0.0
PEUGEOT,406,1996,8,3,37.5,5,62.5,0,0.0
PEUGEOT,406,1997,18,7,38.9,11,61.1,0,0.0
PEUGEOT,406,1998,32,12,37.5,20,62.5,0,0.0
PEUGEOT,406,1999,54,14,25.9,40,74.1,0,0.0
PEUGEOT,406,2000,108,39,36.1,69,63.9,0,0.0
PEUGEOT,406,2001,128,44,34.4,84,65.6,0,0.0
PEUGEOT,406,2002,139,42,30.2,97,69.8,0,0.0
PEUGEOT,406,2003,162,58,35.8,104,64.2,0,0.0
PEUGEOT,406,2004,99,24,24.2,75,75.8,0,0.0
PEUGEOT,406,2005,3,0,0.0,3,100.0,0,0.0
PEUGEOT,407,2004,195,60,30.8,135,69.2,0,0.0
PEUGEOT,407,2005,990,337,34.0,653,66.0,0,0.0
PEUGEOT,407,2006,1113,389,35.0,724,65.0,0,0.0
PEUGEOT,407,2007,1268,514,40.5,754,59.5,0,0.0
PEUGEOT,407,2008,655,272,41.5,383,58.5,0,0.0
PEUGEOT,407,2009,277,138,49.8,139,50.2,0,0.0
PEUGEOT,407,2010,279,157,56.3,122,43.7,0,0.0
PEUGEOT,407,2011,4,1,25.0,3,75.0,0,0.0
PEUGEOT,5008,2009,1,0,0.0,1,100.0,0,0.0
PEUGEOT,5008,2010,738,313,42.4,425,57.6,1,0.1
PEUGEOT,5008,2011,158,100,63.3,58,36.7,0,0.0
PEUGEOT,5008,2012,591,362,61.3,229,38.7,0,0.0
PEUGEOT,5008,2013,88,54,61.4,34,38.6,0,0.0
PEUGEOT,5008,2014,369,237,64.2,132,35.8,1,0.3
PEUGEOT,5008,2015,11,8,72.7,3,27.3,0,0.0
PEUGEOT,5008,2016,2,2,100.0,0,0.0,0,0.0
PEUGEOT,505,1985,1,1,100.0,0,0.0,0,0.0
PEUGEOT,505,1987,1,0,0.0,1,100.0,0,0.0
PEUGEOT,508,2011,115,85,73.9,30,26.1,0,0.0
PEUGEOT,508,2012,860,600,69.8,260,30.2,0,0.0
PEUGEOT,508,2013,159,119,74.8,40,25.2,0,0.0
PEUGEOT,508,2014,343,268,78.1,75,21.9,1,0.3
PEUGEOT,508,2015,56,47,83.9,9,16.1,0,0.0
PEUGEOT,508,2016,4,1,25.0,3,75.0,0,0.0
PEUGEOT,508,2017,2,1,50.0,1,50.0,0,0.0
PEUGEOT,508,2018,1,1,100.0,0,0.0,0,0.0
PEUGEOT,605,1995,1,0,0.0,1,100.0,0,0.0
PEUGEOT,607,2000,1,0,0.0,1,100.0,0,0.0
PEUGEOT,607,2001,7,3,42.9,4,57.1,0,0.0
PEUGEOT,607,2002,17,10,58.8,7,41.2,0,0.0
PEUGEOT,607,2003,21,5,23.8,16,76.2,0,0.0
PEUGEOT,607,2004,30,16,53.3,14,46.7,0,0.0
PEUGEOT,607,2005,23,8,34.8,15,65.2,0,0.0
PEUGEOT,607,2006,27,7,25.9,20,74.1,0,0.0
PEUGEOT,607,2007,18,8,44.4,10,55.6,0,0.0
PEUGEOT,607,2008,13,1,7.7,12,92.3,0,0.0
PEUGEOT,806,2000,3,2,66.7,1,33.3,0,0.0
PEUGEOT,806,2001,3,1,33.3,2,66.7,0,0.0
PEUGEOT,807,2003,5,1,20.0,4,80.0,0,0.0
PEUGEOT,807,2004,20,7,35.0,13,65.0,0,0.0
PEUGEOT,807,2005,22,4,18.2,18,81.8,0,0.0
PEUGEOT,807,2006,31,8,25.8,23,74.2,0,0.0
PEUGEOT,807,2007,24,8,33.3,16,66.7,0,0.0
PEUGEOT,807,2008,7,1,14.3,6,85.7,0,0.0
PEUGEOT,807,2009,3,1,33.3,2,66.7,0,0.0
PEUGEOT,807,2010,3,2,66.7,1,33.3,0,0.0
PEUGEOT,BOXER,2006,3,2,66.7,1,33.3,0,0.0
PEUGEOT,BOXER,2008,1,1,100.0,0,0.0,0,0.0
PEUGEOT,BOXER,2010,1,1,100.0,0,0.0,0,0.0
PEUGEOT,BOXER,2011,3,3,100.0,0,0.0,0,0.0
PEUGEOT,BOXER,2012,8,4,50.0,4,50.0,0,0.0
PEUGEOT,BOXER,2013,5,4,80.0,1,20.0,0,0.0
PEUGEOT,BOXER,2014,8,6,75.0,2,25.0,0,0.0
PEUGEOT,BOXER,2016,1,0,0.0,1,100.0,0,0.0
PEUGEOT,EXPERT,2002,1,0,0.0,1,100.0,0,0.0
PEUGEOT,EXPERT,2003,1,1,100.0,0,0.0,0,0.0
PEUGEOT,EXPERT,2004,2,1,50.0,1,50.0,0,0.0
PEUGEOT,EXPERT,2005,11,3,27.3,8,72.7,0,0.0
PEUGEOT,EXPERT,2006,13,4,30.8,9,69.2,0,0.0
PEUGEOT,EXPERT,2007,10,4,40.0,6,60.0,0,0.0
PEUGEOT,EXPERT,2008,36,13,36.1,23,63.9,0,0.0
PEUGEOT,EXPERT,2009,41,19,46.3,22,53.7,0,0.0
PEUGEOT,EXPERT,2010,61,33,54.1,28,45.9,0,0.0
PEUGEOT,EXPERT,2011,66,29,43.9,37,56.1,1,1.5
PEUGEOT,EXPERT,2012,66,34,51.5,32,48.5,1,1.5
PEUGEOT,EXPERT,2013,24,19,79.2,5,20.8,1,4.2
PEUGEOT,EXPERT,2014,38,23,60.5,15,39.5,3,7.9
PEUGEOT,EXPERT,2015,11,6,54.5,5,45.5,2,18.2
PEUGEOT,EXPERT,2016,4,3,75.0,1,25.0,0,0.0
PEUGEOT,EXPERT,2017,7,3,42.9,4,57.1,0,0.0
PEUGEOT,ION,2012,1,0,0.0,1,100.0,1,100.0
PEUGEOT,OTHER,1996,1,0,0.0,1,100.0,0,0.0
PEUGEOT,OTHER,1999,2,0,0.0,2,100.0,0,0.0
PEUGEOT,OTHER,2000,4,1,25.0,3,75.0,0,0.0
PEUGEOT,OTHER,2001,1,0,0.0,1,100.0,0,0.0
PEUGEOT,OTHER,2002,1,0,0.0,1,100.0,0,0.0
PEUGEOT,OTHER,2003,8,4,50.0,4,50.0,0,0.0
PEUGEOT,OTHER,2004,9,3,33.3,6,66.7,0,0.0
PEUGEOT,OTHER,2005,56,20,35.7,36,64.3,0,0.0
PEUGEOT,OTHER,2006,332,139,41.9,193,58.1,0,0.0
PEUGEOT,OTHER,2007,176,86,48.9,90,51.1,0,0.0
PEUGEOT,OTHER,2008,122,50,41.0,72,59.0,1,0.8
PEUGEOT,OTHER,2009,2,2,100.0,0,0.0,0,0.0
PEUGEOT,OTHER,2010,2,0,0.0,2,100.0,0,0.0
PEUGEOT,OTHER,2011,3,1,33.3,2,66.7,0,0.0
PEUGEOT,OTHER,2012,5,4,80.0,1,20.0,0,0.0
PEUGEOT,OTHER,2013,1,1,100.0,0,0.0,0,0.0
PEUGEOT,OTHER,2014,1,1,100.0,0,0.0,0,0.0
PEUGEOT,PARTNER,2002,3,1,33.3,2,66.7,0,0.0
PEUGEOT,PARTNER,2003,6,2,33.3,4,66.7,0,0.0
PEUGEOT,PARTNER,2004,8,2,25.0,6,75.0,0,0.0
PEUGEOT,PARTNER,2005,28,14,50.0,14,50.0,0,0.0
PEUGEOT,PARTNER,2006,26,8,30.8,18,69.2,0,0.0
PEUGEOT,PARTNER,2007,11,2,18.2,9,81.8,0,0.0
PEUGEOT,PARTNER,2008,26,14,53.8,12,46.2,0,0.0
PEUGEOT,PARTNER,2009,34,12,35.3,22,64.7,1,2.9
PEUGEOT,PARTNER,2010,77,35,45.5,42,54.5,1,1.3
PEUGEOT,PARTNER,2011,173,68,39.3,105,60.7,3,1.7
PEUGEOT,PARTNER,2012,373,176,47.2,197,52.8,7,1.9
PEUGEOT,PARTNER,2013,285,178,62.5,107,37.5,7,2.5
PEUGEOT,PARTNER,2014,179,95,53.1,84,46.9,9,5.0
PEUGEOT,PARTNER,2015,68,35,51.5,33,48.5,5,7.4
PEUGEOT,PARTNER,2016,56,35,62.5,21,37.5,6,10.7
PEUGEOT,PARTNER,2017,23,11,47.8,12,52.2,5,21.7
PEUGEOT,PARTNER,2018,3,2,66.7,1,33.3,1,33.3
PEUGEOT,RCZ,2010,18,11,61.1,7,38.9,0,0.0
PEUGEOT,RCZ,2011,23,16,69.6,7,30.4,0,0.0
PEUGEOT,RCZ,2012,31,25,80.6,6,19.4,0,0.0
PEUGEOT,RCZ,2013,10,8,80.0,2,20.0,0,0.0
PEUGEOT,RCZ,2014,24,16,66.7,8,33.3,0,0.0
POLLMANN,OTHER,2014,1,0,0.0,1,100.0,0,0.0
PONTIAC,OTHER,1984,1,0,0.0,1,100.0,0,0.0
PORSCHE,718,2014,5,5,100.0,0,0.0,0,0.0
PORSCHE,911,1980,2,0,0.0,2,100.0,0,0.0
PORSCHE,911,1981,4,2,50.0,2,50.0,0,0.0
PORSCHE,911,1982,5,2,40.0,3,60.0,0,0.0
PORSCHE,911,1984,3,0,0.0,3,100.0,0,0.0
PORSCHE,911,1985,4,1,25.0,3,75.0,0,0.0
PORSCHE,911,1986,2,1,50.0,1,50.0,0,0.0
PORSCHE,911,1987,1,1,100.0,0,0.0,0,0.0
PORSCHE,911,1988,3,0,0.0,3,100.0,0,0.0
PORSCHE,911,1989,1,0,0.0,1,100.0,0,0.0
PORSCHE,911,1990,7,3,42.9,4,57.1,0,0.0
PORSCHE,911,1992,1,1,100.0,0,0.0,0,0.0
PORSCHE,911,1993,2,0,0.0,2,100.0,0,0.0
PORSCHE,911,1994,6,3,50.0,3,50.0,0,0.0
PORSCHE,911,1995,9,6,66.7,3,33.3,0,0.0
PORSCHE,911,1996,5,5,100.0,0,0.0,0,0.0
PORSCHE,911,1997,1,1,100.0,0,0.0,0,0.0
PORSCHE,911,1998,13,7,53.8,6,46.2,0,0.0
PORSCHE,911,1999,4,2,50.0,2,50.0,0,0.0
PORSCHE,911,2000,4,3,75.0,1,25.0,0,0.0
PORSCHE,911,2001,8,4,50.0,4,50.0,0,0.0
PORSCHE,911,2002,19,7,36.8,12,63.2,0,0.0
PORSCHE,911,2003,21,10,47.6,11,52.4,0,0.0
PORSCHE,911,2004,18,11,61.1,7,38.9,0,0.0
PORSCHE,911,2005,39,23,59.0,16,41.0,0,0.0
PORSCHE,911,2006,36,28,77.8,8,22.2,0,0.0
PORSCHE,911,2007,47,31,66.0,16,34.0,0,0.0
PORSCHE,911,2008,13,10,76.9,3,23.1,0,0.0
PORSCHE,911,2009,2,2,100.0,0,0.0,0,0.0
PORSCHE,911,2010,10,9,90.0,1,10.0,0,0.0
PORSCHE,911,2011,1,1,100.0,0,0.0,0,0.0
PORSCHE,911,2012,7,6,85.7,1,14.3,0,0.0
PORSCHE,911,2013,2,1,50.0,1,50.0,0,0.0
PORSCHE,911,2014,3,3,100.0,0,0.0,0,0.0
PORSCHE,911 CARRERA 2 S,2008,1,1,100.0,0,0.0,0,0.0
PORSCHE,911 CARRERA 2DR,1992,1,1,100.0,0,0.0,0,0.0
PORSCHE,911 CARRERA 2DR,2012,1,1,100.0,0,0.0,0,0.0
PORSCHE,924,1980,1,1,100.0,0,0.0,0,0.0
PORSCHE,991,2015,1,0,0.0,1,100.0,0,0.0
PORSCHE,996 CARRERA 2,2010,1,1,100.0,0,0.0,0,0.0
PORSCHE,996 CARRERA 2,2012,6,3,50.0,3,50.0,0,0.0
PORSCHE,996 CARRERA 2,2014,12,9,75.0,3,25.0,0,0.0
PORSCHE,996 CARRERA 2,2015,1,1,100.0,0,0.0,0,0.0
PORSCHE,BOXSTER,1997,5,4,80.0,1,20.0,0,0.0
PORSCHE,BOXSTER,1999,4,2,50.0,2,50.0,0,0.0
PORSCHE,BOXSTER,2000,2,1,50.0,1,50.0,0,0.0
PORSCHE,BOXSTER,2001,6,5,83.3,1,16.7,0,0.0
PORSCHE,BOXSTER,2002,2,2,100.0,0,0.0,0,0.0
PORSCHE,BOXSTER,2003,2,0,0.0,2,100.0,0,0.0
PORSCHE,BOXSTER,2005,6,5,83.3,1,16.7,0,0.0
PORSCHE,BOXSTER,2006,6,3,50.0,3,50.0,0,0.0
PORSCHE,BOXSTER,2012,1,1,100.0,0,0.0,0,0.0
PORSCHE,BOXSTER,2013,2,2,100.0,0,0.0,0,0.0
PORSCHE,BOXSTER,2014,3,2,66.7,1,33.3,0,0.0
PORSCHE,BOXSTER S TIPTRONIC,2012,1,0,0.0,1,100.0,0,0.0
PORSCHE,BOXTER S,2005,1,1,100.0,0,0.0,0,0.0
PORSCHE,CARRERA,2006,1,1,100.0,0,0.0,0,0.0
PORSCHE,CARRERA,2007,1,0,0.0,1,100.0,0,0.0
PORSCHE,CARRERA,2012,2,2,100.0,0,0.0,0,0.0
PORSCHE,CAYENNE,2003,2,2,100.0,0,0.0,0,0.0
PORSCHE,CAYENNE,2004,8,3,37.5,5,62.5,0,0.0
PORSCHE,CAYENNE,2005,9,8,88.9,1,11.1,0,0.0
PORSCHE,CAYENNE,2006,23,14,60.9,9,39.1,0,0.0
PORSCHE,CAYENNE,2007,18,6,33.3,12,66.7,0,0.0
PORSCHE,CAYENNE,2008,10,6,60.0,4,40.0,0,0.0
PORSCHE,CAYENNE,2009,3,1,33.3,2,66.7,0,0.0
PORSCHE,CAYENNE,2010,6,4,66.7,2,33.3,0,0.0
PORSCHE,CAYENNE,2012,7,4,57.1,3,42.9,0,0.0
PORSCHE,CAYENNE,2013,6,3,50.0,3,50.0,0,0.0
PORSCHE,CAYENNE,2014,22,19,86.4,3,13.6,0,0.0
PORSCHE,CAYENNE 3.2 V6 5DR,2006,1,0,0.0,1,100.0,0,0.0
PORSCHE,CAYMAN,2006,1,1,100.0,0,0.0,0,0.0
PORSCHE,CAYMAN,2007,3,2,66.7,1,33.3,0,0.0
PORSCHE,CAYMAN,2009,3,3,100.0,0,0.0,0,0.0
PORSCHE,CAYMAN,2011,2,2,100.0,0,0.0,0,0.0
PORSCHE,CAYMAN,2012,1,1,100.0,0,0.0,0,0.0
PORSCHE,CAYMAN,2014,3,2,66.7,1,33.3,0,0.0
PORSCHE,MACAN,2014,1,1,100.0,0,0.0,0,0.0
PORSCHE,OTHER,1980,1,0,0.0,1,100.0,0,0.0
PORSCHE,OTHER,1981,4,3,75.0,1,25.0,0,0.0
PORSCHE,OTHER,1982,3,0,0.0,3,100.0,0,0.0
PORSCHE,OTHER,1983,4,3,75.0,1,25.0,0,0.0
PORSCHE,OTHER,1984,7,4,57.1,3,42.9,0,0.0
PORSCHE,OTHER,1985,14,9,64.3,5,35.7,0,0.0
PORSCHE,OTHER,1986,17,4,23.5,13,76.5,0,0.0
PORSCHE,OTHER,1987,19,9,47.4,10,52.6,0,0.0
PORSCHE,OTHER,1988,11,4,36.4,7,63.6,0,0.0
PORSCHE,OTHER,1989,9,3,33.3,6,66.7,0,0.0
PORSCHE,OTHER,1990,9,2,22.2,7,77.8,0,0.0
PORSCHE,OTHER,1991,10,4,40.0,6,60.0,0,0.0
PORSCHE,OTHER,1992,4,3,75.0,1,25.0,0,0.0
PORSCHE,OTHER,1993,3,1,33.3,2,66.7,0,0.0
PORSCHE,OTHER,1994,3,2,66.7,1,33.3,0,0.0
PORSCHE,OTHER,1995,4,1,25.0,3,75.0,0,0.0
PORSCHE,OTHER,1996,3,2,66.7,1,33.3,0,0.0
PORSCHE,OTHER,1997,9,4,44.4,5,55.6,0,0.0
PORSCHE,OTHER,1998,34,19,55.9,15,44.1,0,0.0
PORSCHE,OTHER,1999,17,9,52.9,8,47.1,0,0.0
PORSCHE,OTHER,2000,38,27,71.1,11,28.9,0,0.0
PORSCHE,OTHER,2001,33,18,54.5,15,45.5,0,0.0
PORSCHE,OTHER,2002,38,20,52.6,18,47.4,0,0.0
PORSCHE,OTHER,2003,45,20,44.4,25,55.6,0,0.0
PORSCHE,OTHER,2004,33,17,51.5,16,48.5,0,0.0
PORSCHE,OTHER,2005,45,26,57.8,19,42.2,0,0.0
PORSCHE,OTHER,2006,67,38,56.7,29,43.3,0,0.0
PORSCHE,OTHER,2007,46,31,67.4,15,32.6,1,2.2
PORSCHE,OTHER,2008,19,11,57.9,8,42.1,0,0.0
PORSCHE,OTHER,2009,1,1,100.0,0,0.0,0,0.0
PORSCHE,OTHER,2010,1,1,100.0,0,0.0,0,0.0
PORSCHE,OTHER,2013,1,1,100.0,0,0.0,0,0.0
PORSCHE,OTHER,2014,20,15,75.0,5,25.0,0,0.0
PORSCHE,OTHER,2015,2,2,100.0,0,0.0,0,0.0
PORSCHE,PANAMERA,2010,1,1,100.0,0,0.0,0,0.0
PORSCHE,PANAMERA,2011,1,1,100.0,0,0.0,0,0.0
PORSCHE,PANAMERA,2012,3,3,100.0,0,0.0,0,0.0
PORSCHE,PANAMERA,2013,1,0,0.0,1,100.0,0,0.0
PORSCHE,PANAMERA,2014,12,10,83.3,2,16.7,0,0.0
PORSCHE,PANAMERA,2015,1,0,0.0,1,100.0,0,0.0
PORSCHE,PANAMERA 4S,2010,1,1,100.0,0,0.0,0,0.0
PROTON,GEN 2,2005,1,0,0.0,1,100.0,0,0.0
PROTON,GEN 2,2006,2,1,50.0,1,50.0,0,0.0
PROTON,GEN 2,2007,1,0,0.0,1,100.0,0,0.0
PROTON,OTHER,2000,1,0,0.0,1,100.0,0,0.0
PROTON,OTHER,2002,1,0,0.0,1,100.0,0,0.0
PROTON,OTHER,2003,1,0,0.0,1,100.0,0,0.0
PROTON,OTHER,2004,1,0,0.0,1,100.0,0,0.0
PROTON,OTHER,2010,1,0,0.0,1,100.0,0,0.0
PROTON,PROTON IMPIAN,2007,2,0,0.0,2,100.0,0,0.0
PROTON,SATRIA,2007,2,1,50.0,1,50.0,0,0.0
PROTON,SAVVY,2009,1,0,0.0,1,100.0,0,0.0
PROTON,SAVVY,2010,2,0,0.0,2,100.0,0,0.0
PROTON,SAVVY,2011,1,0,0.0,1,100.0,0,0.0
REGENT,LONDON TAXI,1990,2,1,50.0,1,50.0,0,0.0
REGENT,LONDON TAXI,2001,1,0,0.0,1,100.0,0,0.0
REGENT,OTHER,1989,3,1,33.3,2,66.7,0,0.0
REGENT,OTHER,1991,4,2,50.0,2,50.0,0,0.0
RELIANT,OTHER,1978,1,0,0.0,1,100.0,0,0.0
RELIANT,OTHER,1988,1,0,0.0,1,100.0,0,0.0
RELIANT,OTHER,1989,1,1,100.0,0,0.0,0,0.0
RENAULT,11,1986,1,0,0.0,1,100.0,0,0.0
RENAULT,14,1980,1,0,0.0,1,100.0,0,0.0
RENAULT,18,1985,1,1,100.0,0,0.0,0,0.0
RENAULT,19,1989,2,1,50.0,1,50.0,0,0.0
RENAULT,19,1990,4,2,50.0,2,50.0,0,0.0
RENAULT,19,1991,1,1,100.0,0,0.0,0,0.0
RENAULT,19,1992,2,0,0.0,2,100.0,0,0.0
RENAULT,19,1993,5,3,60.0,2,40.0,0,0.0
RENAULT,19,1994,1,1,100.0,0,0.0,0,0.0
RENAULT,19,1995,1,0,0.0,1,100.0,0,0.0
RENAULT,19,1996,1,1,100.0,0,0.0,0,0.0
RENAULT,21,1989,2,2,100.0,0,0.0,0,0.0
RENAULT,21,1993,1,1,100.0,0,0.0,0,0.0
RENAULT,25,1986,1,0,0.0,1,100.0,0,0.0
RENAULT,25,1988,2,0,0.0,2,100.0,0,0.0
RENAULT,25,1991,1,1,100.0,0,0.0,0,0.0
RENAULT,5,1981,1,1,100.0,0,0.0,0,0.0
RENAULT,5,1984,1,1,100.0,0,0.0,0,0.0
RENAULT,5,1986,1,1,100.0,0,0.0,0,0.0
RENAULT,5,1988,5,1,20.0,4,80.0,0,0.0
RENAULT,5,1989,3,1,33.3,2,66.7,0,0.0
RENAULT,5,1990,1,1,100.0,0,0.0,0,0.0
RENAULT,5,1991,3,3,100.0,0,0.0,0,0.0
RENAULT,5,1996,1,0,0.0,1,100.0,0,0.0
RENAULT,9,1983,1,1,100.0,0,0.0,0,0.0
RENAULT,CABRIO,2006,6,2,33.3,4,66.7,0,0.0
RENAULT,CABRIO,2007,60,19,31.7,41,68.3,0,0.0
RENAULT,CABRIO,2008,24,6,25.0,18,75.0,0,0.0
RENAULT,CABRIO,2009,1,0,0.0,1,100.0,0,0.0
RENAULT,CAPTUR,2013,22,13,59.1,9,40.9,0,0.0
RENAULT,CAPTUR,2014,1136,832,73.2,304,26.8,0,0.0
RENAULT,CAPTUR,2015,124,94,75.8,30,24.2,0,0.0
RENAULT,CLASSIC,1997,7,4,57.1,3,42.9,0,0.0
RENAULT,CLASSIC,1998,11,2,18.2,9,81.8,0,0.0
RENAULT,CLASSIC,1999,5,2,40.0,3,60.0,0,0.0
RENAULT,CLASSIC,2000,63,24,38.1,39,61.9,0,0.0
RENAULT,CLASSIC,2001,118,47,39.8,71,60.2,0,0.0
RENAULT,CLASSIC,2002,14,6,42.9,8,57.1,0,0.0
RENAULT,CLIO,1991,1,0,0.0,1,100.0,0,0.0
RENAULT,CLIO,1994,4,3,75.0,1,25.0,0,0.0
RENAULT,CLIO,1995,7,3,42.9,4,57.1,0,0.0
RENAULT,CLIO,1996,16,8,50.0,8,50.0,0,0.0
RENAULT,CLIO,1997,41,18,43.9,23,56.1,0,0.0
RENAULT,CLIO,1998,63,27,42.9,36,57.1,0,0.0
RENAULT,CLIO,1999,221,64,29.0,157,71.0,0,0.0
RENAULT,CLIO,2000,479,125,26.1,354,73.9,0,0.0
RENAULT,CLIO,2001,485,140,28.9,345,71.1,0,0.0
RENAULT,CLIO,2002,931,279,30.0,652,70.0,0,0.0
RENAULT,CLIO,2003,1028,290,28.2,738,71.8,1,0.1
RENAULT,CLIO,2004,1158,344,29.7,814,70.3,0,0.0
RENAULT,CLIO,2005,1098,342,31.1,756,68.9,0,0.0
RENAULT,CLIO,2006,2554,1079,42.2,1475,57.8,0,0.0
RENAULT,CLIO,2007,1835,766,41.7,1069,58.3,0,0.0
RENAULT,CLIO,2008,650,274,42.2,376,57.8,0,0.0
RENAULT,CLIO,2009,417,159,38.1,258,61.9,1,0.2
RENAULT,CLIO,2010,3010,1515,50.3,1495,49.7,1,0.0
RENAULT,CLIO,2011,300,137,45.7,163,54.3,0,0.0
RENAULT,CLIO,2012,1008,610,60.5,398,39.5,0,0.0
RENAULT,CLIO,2013,143,104,72.7,39,27.3,0,0.0
RENAULT,CLIO,2014,1648,1381,83.8,267,16.2,0,0.0
RENAULT,CLIO,2015,146,127,87.0,19,13.0,0,0.0
RENAULT,CLIO,2016,5,1,20.0,4,80.0,0,0.0
RENAULT,CLIO 1.2 CAMPUS 3DR,2006,1,0,0.0,1,100.0,0,0.0
RENAULT,CLIO 3 1.5DCI CONFERT EXP,2006,1,0,0.0,1,100.0,0,0.0
RENAULT,ESPACE,1998,2,1,50.0,1,50.0,0,0.0
RENAULT,ESPACE,1999,3,1,33.3,2,66.7,0,0.0
RENAULT,ESPACE,2000,4,1,25.0,3,75.0,0,0.0
RENAULT,ESPACE,2001,5,0,0.0,5,100.0,0,0.0
RENAULT,ESPACE,2002,6,1,16.7,5,83.3,0,0.0
RENAULT,ESPACE,2003,7,4,57.1,3,42.9,0,0.0
RENAULT,ESPACE,2004,39,9,23.1,30,76.9,0,0.0
RENAULT,ESPACE,2005,35,11,31.4,24,68.6,0,0.0
RENAULT,ESPACE,2006,39,12,30.8,27,69.2,0,0.0
RENAULT,ESPACE,2007,64,18,28.1,46,71.9,0,0.0
RENAULT,ESPACE,2008,20,8,40.0,12,60.0,0,0.0
RENAULT,ESPACE,2009,2,0,0.0,2,100.0,0,0.0
RENAULT,ESPACE,2010,1,0,0.0,1,100.0,0,0.0
RENAULT,ESPACE,2011,2,1,50.0,1,50.0,0,0.0
RENAULT,ESPACE,2012,5,2,40.0,3,60.0,0,0.0
RENAULT,FLUENCE,2010,1173,558,47.6,615,52.4,0,0.0
RENAULT,FLUENCE,2011,502,248,49.4,254,50.6,0,0.0
RENAULT,FLUENCE,2012,1567,1030,65.7,537,34.3,2,0.1
RENAULT,FLUENCE,2013,184,121,65.8,63,34.2,0,0.0
RENAULT,FLUENCE,2014,917,685,74.7,232,25.3,2,0.2
RENAULT,FLUENCE,2015,228,179,78.5,49,21.5,0,0.0
RENAULT,FLUENCE,2016,61,47,77.0,14,23.0,0,0.0
RENAULT,FLUENCE,2017,11,11,100.0,0,0.0,0,0.0
RENAULT,FUEGO,1984,2,1,50.0,1,50.0,0,0.0
RENAULT,GRAND CLIO,2008,1,0,0.0,1,100.0,0,0.0
RENAULT,GRAND CLIO,2010,65,30,46.2,35,53.8,0,0.0
RENAULT,GRAND CLIO,2011,5,3,60.0,2,40.0,0,0.0
RENAULT,GRAND ESPACE,2002,2,0,0.0,2,100.0,0,0.0
RENAULT,GRAND ESPACE,2004,1,0,0.0,1,100.0,0,0.0
RENAULT,GRAND ESPACE,2005,16,4,25.0,12,75.0,1,6.3
RENAULT,GRAND ESPACE,2006,74,19,25.7,55,74.3,0,0.0
RENAULT,GRAND ESPACE,2007,28,7,25.0,21,75.0,0,0.0
RENAULT,GRAND ESPACE,2008,29,11,37.9,18,62.1,0,0.0
RENAULT,GRAND ESPACE,2009,6,1,16.7,5,83.3,0,0.0
RENAULT,GRAND ESPACE,2010,15,8,53.3,7,46.7,0,0.0
RENAULT,GRAND ESPACE,2011,4,2,50.0,2,50.0,0,0.0
RENAULT,GRAND ESPACE,2012,7,3,42.9,4,57.1,0,0.0
RENAULT,GRAND MEGANE,2010,1054,480,45.5,574,54.5,0,0.0
RENAULT,GRAND MEGANE,2011,120,53,44.2,67,55.8,0,0.0
RENAULT,GRAND MEGANE,2012,417,239,57.3,178,42.7,0,0.0
RENAULT,GRAND MEGANE,2013,50,32,64.0,18,36.0,0,0.0
RENAULT,GRAND MEGANE,2014,220,137,62.3,83,37.7,0,0.0
RENAULT,GRAND MEGANE,2015,22,14,63.6,8,36.4,0,0.0
RENAULT,GRAND MEGANE,2016,2,2,100.0,0,0.0,0,0.0
RENAULT,GRAND MODUS,2008,70,28,40.0,42,60.0,0,0.0
RENAULT,GRAND MODUS,2009,25,7,28.0,18,72.0,0,0.0
RENAULT,GRAND MODUS,2010,29,13,44.8,16,55.2,0,0.0
RENAULT,GRAND MODUS,2011,6,1,16.7,5,83.3,0,0.0
RENAULT,GRAND MODUS,2012,1,1,100.0,0,0.0,0,0.0
RENAULT,GRAND SCENIC,2004,23,3,13.0,20,87.0,0,0.0
RENAULT,GRAND SCENIC,2005,184,41,22.3,143,77.7,0,0.0
RENAULT,GRAND SCENIC,2006,326,81,24.8,245,75.2,0,0.0
RENAULT,GRAND SCENIC,2007,750,169,22.5,581,77.5,0,0.0
RENAULT,GRAND SCENIC,2008,465,119,25.6,346,74.4,1,0.2
RENAULT,GRAND SCENIC,2009,85,21,24.7,64,75.3,0,0.0
RENAULT,GRAND SCENIC,2010,1005,406,40.4,599,59.6,0,0.0
RENAULT,GRAND SCENIC,2011,166,72,43.4,94,56.6,0,0.0
RENAULT,GRAND SCENIC,2012,268,162,60.4,106,39.6,0,0.0
RENAULT,GRAND SCENIC,2013,38,22,57.9,16,42.1,0,0.0
RENAULT,GRAND SCENIC,2014,172,112,65.1,60,34.9,0,0.0
RENAULT,GRAND SCENIC,2015,12,10,83.3,2,16.7,0,0.0
RENAULT,GRAND SCENIC,2016,2,1,50.0,1,50.0,0,0.0
RENAULT,GRAND SCENIC,2017,1,0,0.0,1,100.0,0,0.0
RENAULT,KADJAR,2016,10,6,60.0,4,40.0,0,0.0
RENAULT,KADJAR,2017,1,1,100.0,0,0.0,0,0.0
RENAULT,KANGOO,2000,34,5,14.7,29,85.3,0,0.0
RENAULT,KANGOO,2001,50,15,30.0,35,70.0,0,0.0
RENAULT,KANGOO,2002,63,20,31.7,43,68.3,0,0.0
RENAULT,KANGOO,2003,93,29,31.2,64,68.8,0,0.0
RENAULT,KANGOO,2004,95,33,34.7,62,65.3,0,0.0
RENAULT,KANGOO,2005,113,39,34.5,74,65.5,0,0.0
RENAULT,KANGOO,2006,92,41,44.6,51,55.4,1,1.1
RENAULT,KANGOO,2007,102,41,40.2,61,59.8,2,2.0
RENAULT,KANGOO,2008,76,36,47.4,40,52.6,1,1.3
RENAULT,KANGOO,2009,17,8,47.1,9,52.9,0,0.0
RENAULT,KANGOO,2010,40,13,32.5,27,67.5,0,0.0
RENAULT,KANGOO,2011,8,7,87.5,1,12.5,0,0.0
RENAULT,KANGOO,2012,8,2,25.0,6,75.0,1,12.5
RENAULT,KANGOO,2016,1,0,0.0,1,100.0,0,0.0
RENAULT,KANGOO 1.4 AUTHENTIQUE 5DR A,2002,1,0,0.0,1,100.0,0,0.0
RENAULT,KERAX,2006,1,1,100.0,0,0.0,0,0.0
RENAULT,KOLEOS,2008,29,12,41.4,17,58.6,0,0.0
RENAULT,KOLEOS,2009,19,9,47.4,10,52.6,0,0.0
RENAULT,KOLEOS,2010,2,2,100.0,0,0.0,0,0.0
RENAULT,KOLEOS,2012,1,0,0.0,1,100.0,0,0.0
RENAULT,LAGUNA,1994,1,0,0.0,1,100.0,0,0.0
RENAULT,LAGUNA,1995,1,0,0.0,1,100.0,0,0.0
RENAULT,LAGUNA,1996,2,1,50.0,1,50.0,0,0.0
RENAULT,LAGUNA,1997,3,1,33.3,2,66.7,0,0.0
RENAULT,LAGUNA,1998,9,3,33.3,6,66.7,0,0.0
RENAULT,LAGUNA,1999,25,8,32.0,17,68.0,0,0.0
RENAULT,LAGUNA,2000,53,13,24.5,40,75.5,0,0.0
RENAULT,LAGUNA,2001,82,20,24.4,62,75.6,0,0.0
RENAULT,LAGUNA,2002,178,51,28.7,127,71.3,0,0.0
RENAULT,LAGUNA,2003,279,68,24.4,211,75.6,0,0.0
RENAULT,LAGUNA,2004,294,71,24.1,223,75.9,1,0.3
RENAULT,LAGUNA,2005,408,108,26.5,300,73.5,0,0.0
RENAULT,LAGUNA,2006,464,119,25.6,345,74.4,1,0.2
RENAULT,LAGUNA,2007,210,63,30.0,147,70.0,0,0.0
RENAULT,LAGUNA,2008,912,377,41.3,535,58.7,1,0.1
RENAULT,LAGUNA,2009,256,124,48.4,132,51.6,0,0.0
RENAULT,LAGUNA,2010,274,142,51.8,132,48.2,0,0.0
RENAULT,LAGUNA,2011,78,46,59.0,32,41.0,0,0.0
RENAULT,LAGUNA,2012,106,75,70.8,31,29.2,0,0.0
RENAULT,LAGUNA,2013,17,13,76.5,4,23.5,0,0.0
RENAULT,LAGUNA GT DCI,2005,1,1,100.0,0,0.0,0,0.0
RENAULT,MASTER,2002,2,2,100.0,0,0.0,0,0.0
RENAULT,MASTER,2004,1,0,0.0,1,100.0,0,0.0
RENAULT,MASTER,2005,2,0,0.0,2,100.0,0,0.0
RENAULT,MASTER,2006,8,0,0.0,8,100.0,0,0.0
RENAULT,MASTER,2007,6,3,50.0,3,50.0,0,0.0
RENAULT,MASTER,2008,3,1,33.3,2,66.7,1,33.3
RENAULT,MASTER,2009,2,1,50.0,1,50.0,0,0.0
RENAULT,MASTER,2010,4,2,50.0,2,50.0,0,0.0
RENAULT,MASTER,2011,8,1,12.5,7,87.5,0,0.0
RENAULT,MASTER,2012,7,3,42.9,4,57.1,0,0.0
RENAULT,MASTER,2013,4,4,100.0,0,0.0,0,0.0
RENAULT,MASTER,2014,4,2,50.0,2,50.0,0,0.0
RENAULT,MEGANE,1996,5,2,40.0,3,60.0,0,0.0
RENAULT,MEGANE,1997,4,1,25.0,3,75.0,0,0.0
RENAULT,MEGANE,1998,15,6,40.0,9,60.0,0,0.0
RENAULT,MEGANE,1999,65,29,44.6,36,55.4,0,0.0
RENAULT,MEGANE,2000,227,72,31.7,155,68.3,0,0.0
RENAULT,MEGANE,2001,250,84,33.6,166,66.4,0,0.0
RENAULT,MEGANE,2002,804,278,34.6,526,65.4,0,0.0
RENAULT,MEGANE,2003,1098,265,24.1,833,75.9,0,0.0
RENAULT,MEGANE,2004,2165,522,24.1,1643,75.9,1,0.0
RENAULT,MEGANE,2005,3200,827,25.8,2373,74.2,0,0.0
RENAULT,MEGANE,2006,2549,724,28.4,1825,71.6,0,0.0
RENAULT,MEGANE,2007,1706,497,29.1,1209,70.9,2,0.1
RENAULT,MEGANE,2008,619,159,25.7,460,74.3,2,0.3
RENAULT,MEGANE,2009,482,180,37.3,302,62.7,0,0.0
RENAULT,MEGANE,2010,2779,1362,49.0,1417,51.0,1,0.0
RENAULT,MEGANE,2011,345,167,48.4,178,51.6,0,0.0
RENAULT,MEGANE,2012,1180,777,65.8,403,34.2,1,0.1
RENAULT,MEGANE,2013,164,102,62.2,62,37.8,0,0.0
RENAULT,MEGANE,2014,453,302,66.7,151,33.3,0,0.0
RENAULT,MEGANE,2015,49,32,65.3,17,34.7,0,0.0
RENAULT,MEGANE,2016,2,1,50.0,1,50.0,0,0.0
RENAULT,MEGANE,2017,14,14,100.0,0,0.0,0,0.0
RENAULT,MEGANE,2018,4,3,75.0,1,25.0,0,0.0
RENAULT,MEGAVAN,2008,1,0,0.0,1,100.0,0,0.0
RENAULT,MODUS,2004,39,10,25.6,29,74.4,0,0.0
RENAULT,MODUS,2005,464,150,32.3,314,67.7,0,0.0
RENAULT,MODUS,2006,122,42,34.4,80,65.6,0,0.0
RENAULT,MODUS,2007,20,10,50.0,10,50.0,0,0.0
RENAULT,MODUS,2008,14,7,50.0,7,50.0,0,0.0
RENAULT,MODUS,2009,4,1,25.0,3,75.0,0,0.0
RENAULT,MODUS,2010,7,2,28.6,5,71.4,1,14.3
RENAULT,OTHER,1987,1,0,0.0,1,100.0,0,0.0
RENAULT,OTHER,1988,2,0,0.0,2,100.0,0,0.0
RENAULT,OTHER,1989,1,0,0.0,1,100.0,0,0.0
RENAULT,OTHER,1995,1,1,100.0,0,0.0,0,0.0
RENAULT,OTHER,1996,1,1,100.0,0,0.0,0,0.0
RENAULT,OTHER,1997,2,0,0.0,2,100.0,0,0.0
RENAULT,OTHER,1998,2,0,0.0,2,100.0,0,0.0
RENAULT,OTHER,1999,3,3,100.0,0,0.0,0,0.0
RENAULT,OTHER,2000,24,8,33.3,16,66.7,0,0.0
RENAULT,OTHER,2001,44,10,22.7,34,77.3,0,0.0
RENAULT,OTHER,2002,24,5,20.8,19,79.2,0,0.0
RENAULT,OTHER,2003,18,11,61.1,7,38.9,0,0.0
RENAULT,OTHER,2004,47,10,21.3,37,78.7,0,0.0
RENAULT,OTHER,2005,51,16,31.4,35,68.6,0,0.0
RENAULT,OTHER,2006,32,13,40.6,19,59.4,0,0.0
RENAULT,OTHER,2007,14,6,42.9,8,57.1,0,0.0
RENAULT,OTHER,2008,41,14,34.1,27,65.9,0,0.0
RENAULT,OTHER,2009,3,1,33.3,2,66.7,0,0.0
RENAULT,OTHER,2010,24,9,37.5,15,62.5,0,0.0
RENAULT,OTHER,2011,1,0,0.0,1,100.0,0,0.0
RENAULT,OTHER,2012,7,4,57.1,3,42.9,0,0.0
RENAULT,OTHER,2014,1,0,0.0,1,100.0,0,0.0
RENAULT,OTHER,2015,1,1,100.0,0,0.0,0,0.0
RENAULT,PRESTIGE,2006,1,0,0.0,1,100.0,0,0.0
RENAULT,PRESTIGE,2008,7,5,71.4,2,28.6,0,0.0
RENAULT,PRESTIGE,2009,1,0,0.0,1,100.0,0,0.0
RENAULT,R4,1984,1,0,0.0,1,100.0,0,0.0
RENAULT,SAFRANNE,1998,1,1,100.0,0,0.0,0,0.0
RENAULT,SAFRANNE,1999,2,2,100.0,0,0.0,0,0.0
RENAULT,SCENIC,1997,2,1,50.0,1,50.0,0,0.0
RENAULT,SCENIC,1998,4,2,50.0,2,50.0,0,0.0
RENAULT,SCENIC,1999,9,2,22.2,7,77.8,0,0.0
RENAULT,SCENIC,2000,80,21,26.3,59,73.8,0,0.0
RENAULT,SCENIC,2001,227,75,33.0,152,67.0,0,0.0
RENAULT,SCENIC,2002,125,36,28.8,89,71.2,0,0.0
RENAULT,SCENIC,2003,68,19,27.9,49,72.1,0,0.0
RENAULT,SCENIC,2004,203,55,27.1,148,72.9,0,0.0
RENAULT,SCENIC,2005,156,34,21.8,122,78.2,0,0.0
RENAULT,SCENIC,2006,427,124,29.0,303,71.0,0,0.0
RENAULT,SCENIC,2007,727,234,32.2,493,67.8,0,0.0
RENAULT,SCENIC,2008,297,86,29.0,211,71.0,0,0.0
RENAULT,SCENIC,2009,68,20,29.4,48,70.6,0,0.0
RENAULT,SCENIC,2010,530,257,48.5,273,51.5,0,0.0
RENAULT,SCENIC,2011,45,24,53.3,21,46.7,0,0.0
RENAULT,SCENIC,2012,172,126,73.3,46,26.7,0,0.0
RENAULT,SCENIC,2013,34,24,70.6,10,29.4,0,0.0
RENAULT,SCENIC,2014,116,83,71.6,33,28.4,0,0.0
RENAULT,SCENIC,2015,15,11,73.3,4,26.7,0,0.0
RENAULT,SCENIC 1.6 SL OASIS VVTI 5DR A,2006,1,1,100.0,0,0.0,0,0.0
RENAULT,TRAFIC,2003,3,1,33.3,2,66.7,0,0.0
RENAULT,TRAFIC,2004,5,3,60.0,2,40.0,0,0.0
RENAULT,TRAFIC,2005,1,1,100.0,0,0.0,0,0.0
RENAULT,TRAFIC,2006,16,4,25.0,12,75.0,0,0.0
RENAULT,TRAFIC,2007,39,12,30.8,27,69.2,0,0.0
RENAULT,TRAFIC,2008,30,8,26.7,22,73.3,0,0.0
RENAULT,TRAFIC,2009,8,2,25.0,6,75.0,0,0.0
RENAULT,TRAFIC,2010,11,4,36.4,7,63.6,0,0.0
RENAULT,TRAFIC,2011,6,3,50.0,3,50.0,0,0.0
RENAULT,TRAFIC,2012,7,2,28.6,5,71.4,0,0.0
RENAULT,TRAFIC,2013,27,8,29.6,19,70.4,0,0.0
RENAULT,TRAFIC,2014,26,13,50.0,13,50.0,0,0.0
RENAULT,TRAFIC,2015,26,15,57.7,11,42.3,0,0.0
RENAULT,TRAFIC,2016,28,24,85.7,4,14.3,0,0.0
RENAULT,TRAFIC,2017,13,13,100.0,0,0.0,0,0.0
RENAULT,TRAFIC,2018,5,2,40.0,3,60.0,1,20.0
RENAULT,TRAFIC LH 29 120BHP 5DR,2007,1,0,0.0,1,100.0,0,0.0
RENAULT,TWINGO,2004,1,0,0.0,1,100.0,0,0.0
RENAULT,TWINGO,2005,1,0,0.0,1,100.0,0,0.0
RENAULT,TWINGO,2007,11,2,18.2,9,81.8,0,0.0
RENAULT,TWINGO,2008,116,57,49.1,59,50.9,0,0.0
RENAULT,TWINGO,2009,22,12,54.5,10,45.5,0,0.0
RENAULT,TWINGO,2010,19,7,36.8,12,63.2,0,0.0
RENAULT,TWINGO,2011,4,1,25.0,3,75.0,0,0.0
RENAULT,TWINGO,2012,6,2,33.3,4,66.7,0,0.0
RENAULT,TWINGO,2013,4,2,50.0,2,50.0,0,0.0
RENAULT,TWINGO,2014,5,4,80.0,1,20.0,0,0.0
RENAULT,TWINGO,2015,13,11,84.6,2,15.4,0,0.0
RENAULT,VELSATIS,2002,1,1,100.0,0,0.0,0,0.0
RENAULT,VELSATIS,2003,1,1,100.0,0,0.0,0,0.0
RENAULT,VELSATIS,2005,1,1,100.0,0,0.0,0,0.0
RENAULT,WIND,2010,2,2,100.0,0,0.0,0,0.0
RENAULT,WIND,2011,4,3,75.0,1,25.0,0,0.0
RENAULT,ZOE,2013,1,1,100.0,0,0.0,0,0.0
RENAULT,ZOE,2014,30,25,83.3,5,16.7,1,3.3
RILEY,OTHER,1955,1,1,100.0,0,0.0,0,0.0
ROLLS ROYCE,OTHER,1932,1,1,100.0,0,0.0,0,0.0
ROLLS ROYCE,OTHER,1939,1,0,0.0,1,100.0,0,0.0
ROLLS ROYCE,OTHER,1948,1,1,100.0,0,0.0,0,0.0
ROLLS ROYCE,OTHER,1950,1,1,100.0,0,0.0,0,0.0
ROLLS ROYCE,OTHER,1951,1,1,100.0,0,0.0,0,0.0
ROLLS ROYCE,OTHER,1957,1,1,100.0,0,0.0,0,0.0
ROLLS ROYCE,OTHER,1960,1,1,100.0,0,0.0,0,0.0
ROLLS ROYCE,OTHER,1964,3,1,33.3,2,66.7,0,0.0
ROLLS ROYCE,OTHER,1965,1,1,100.0,0,0.0,0,0.0
ROLLS ROYCE,OTHER,1966,1,1,100.0,0,0.0,0,0.0
ROLLS ROYCE,OTHER,1976,1,1,100.0,0,0.0,0,0.0
ROLLS ROYCE,OTHER,1978,1,0,0.0,1,100.0,0,0.0
ROLLS ROYCE,OTHER,1980,4,2,50.0,2,50.0,0,0.0
ROLLS ROYCE,OTHER,1981,3,0,0.0,3,100.0,0,0.0
ROLLS ROYCE,OTHER,1983,1,1,100.0,0,0.0,0,0.0
ROLLS ROYCE,OTHER,1984,1,1,100.0,0,0.0,0,0.0
ROLLS ROYCE,OTHER,1985,3,1,33.3,2,66.7,0,0.0
ROLLS ROYCE,OTHER,1986,1,1,100.0,0,0.0,0,0.0
ROLLS ROYCE,OTHER,1988,1,0,0.0,1,100.0,0,0.0
ROLLS ROYCE,OTHER,1990,3,0,0.0,3,100.0,0,0.0
ROLLS ROYCE,OTHER,1991,1,0,0.0,1,100.0,0,0.0
ROLLS ROYCE,OTHER,1995,2,0,0.0,2,100.0,0,0.0
ROLLS ROYCE,OTHER,1997,3,2,66.7,1,33.3,0,0.0
ROLLS ROYCE,OTHER,2000,2,0,0.0,2,100.0,0,0.0
ROLLS ROYCE,OTHER,2004,1,0,0.0,1,100.0,0,0.0
ROLLS ROYCE,OTHER,2007,3,1,33.3,2,66.7,0,0.0
ROLLS ROYCE,PHANTOM,2011,1,1,100.0,0,0.0,0,0.0
ROVER,100 SERIES,1996,1,1,100.0,0,0.0,0,0.0
ROVER,100 SERIES,1997,1,0,0.0,1,100.0,0,0.0
ROVER,200,1999,5,1,20.0,4,80.0,0,0.0
ROVER,200,2000,4,1,25.0,3,75.0,0,0.0
ROVER,214,1990,1,1,100.0,0,0.0,0,0.0
ROVER,214,1993,1,0,0.0,1,100.0,0,0.0
ROVER,214,1994,1,0,0.0,1,100.0,0,0.0
ROVER,214,1997,4,3,75.0,1,25.0,0,0.0
ROVER,214,1998,5,2,40.0,3,60.0,0,0.0
ROVER,214,1999,9,3,33.3,6,66.7,0,0.0
ROVER,216,1991,1,0,0.0,1,100.0,0,0.0
ROVER,216,1992,1,1,100.0,0,0.0,0,0.0
ROVER,216,1994,1,1,100.0,0,0.0,0,0.0
ROVER,218,1995,1,0,0.0,1,100.0,0,0.0
ROVER,25,2000,20,12,60.0,8,40.0,0,0.0
ROVER,25,2001,22,10,45.5,12,54.5,0,0.0
ROVER,25,2002,25,11,44.0,14,56.0,0,0.0
ROVER,25,2003,18,10,55.6,8,44.4,0,0.0
ROVER,25,2004,25,13,52.0,12,48.0,1,4.0
ROVER,25,2005,34,12,35.3,22,64.7,0,0.0
ROVER,25,2006,4,1,25.0,3,75.0,0,0.0
ROVER,400 SERIES,1993,2,2,100.0,0,0.0,0,0.0
ROVER,400 SERIES,1994,2,1,50.0,1,50.0,0,0.0
ROVER,400 SERIES,1996,8,2,25.0,6,75.0,0,0.0
ROVER,400 SERIES,1997,9,5,55.6,4,44.4,0,0.0
ROVER,400 SERIES,1998,5,1,20.0,4,80.0,0,0.0
ROVER,400 SERIES,1999,10,4,40.0,6,60.0,0,0.0
ROVER,400 SERIES,2000,2,0,0.0,2,100.0,0,0.0
ROVER,420,1999,1,1,100.0,0,0.0,0,0.0
ROVER,45,2000,17,5,29.4,12,70.6,0,0.0
ROVER,45,2001,22,7,31.8,15,68.2,0,0.0
ROVER,45,2002,25,11,44.0,14,56.0,0,0.0
ROVER,45,2003,44,14,31.8,30,68.2,0,0.0
ROVER,45,2004,45,17,37.8,28,62.2,0,0.0
ROVER,45,2005,46,13,28.3,33,71.7,0,0.0
ROVER,45,2006,11,3,27.3,8,72.7,0,0.0
ROVER,45,2007,1,0,0.0,1,100.0,0,0.0
ROVER,45,2008,1,0,0.0,1,100.0,0,0.0
ROVER,600 SERIES,1994,2,1,50.0,1,50.0,0,0.0
ROVER,600 SERIES,1995,3,2,66.7,1,33.3,0,0.0
ROVER,600 SERIES,1996,2,1,50.0,1,50.0,0,0.0
ROVER,600 SERIES,1997,8,3,37.5,5,62.5,0,0.0
ROVER,600 SERIES,1998,12,2,16.7,10,83.3,0,0.0
ROVER,600 SERIES,1999,2,1,50.0,1,50.0,0,0.0
ROVER,75,1999,4,1,25.0,3,75.0,0,0.0
ROVER,75,2000,28,9,32.1,19,67.9,0,0.0
ROVER,75,2001,29,9,31.0,20,69.0,0,0.0
ROVER,75,2002,55,17,30.9,38,69.1,0,0.0
ROVER,75,2003,72,20,27.8,52,72.2,0,0.0
ROVER,75,2004,130,40,30.8,90,69.2,0,0.0
ROVER,75,2005,73,29,39.7,44,60.3,0,0.0
ROVER,75,2006,18,6,33.3,12,66.7,0,0.0
ROVER,75,2007,1,0,0.0,1,100.0,0,0.0
ROVER,CITY ROVER,2004,1,0,0.0,1,100.0,0,0.0
ROVER,CITY ROVER,2005,3,0,0.0,3,100.0,0,0.0
ROVER,CITY ROVER,2007,1,0,0.0,1,100.0,0,0.0
ROVER,LAND ROVER DISCOVERY,1996,1,0,0.0,1,100.0,0,0.0
ROVER,LAND ROVER DISCOVERY,1997,5,1,20.0,4,80.0,0,0.0
ROVER,LAND ROVER DISCOVERY,1998,2,1,50.0,1,50.0,0,0.0
ROVER,LAND ROVER DISCOVERY,1999,10,1,10.0,9,90.0,0,0.0
ROVER,LAND ROVER DISCOVERY,2000,20,6,30.0,14,70.0,0,0.0
ROVER,LAND ROVER DISCOVERY,2001,31,8,25.8,23,74.2,0,0.0
ROVER,LAND ROVER DISCOVERY,2002,8,1,12.5,7,87.5,1,12.5
ROVER,LAND ROVER DISCOVERY,2003,1,1,100.0,0,0.0,0,0.0
ROVER,LANDROVER,1983,1,0,0.0,1,100.0,0,0.0
ROVER,LANDROVER,1997,1,0,0.0,1,100.0,0,0.0
ROVER,LANDROVER,1998,5,0,0.0,5,100.0,0,0.0
ROVER,LANDROVER,1999,21,5,23.8,16,76.2,0,0.0
ROVER,LANDROVER,2000,37,12,32.4,25,67.6,0,0.0
ROVER,LANDROVER,2001,86,19,22.1,67,77.9,0,0.0
ROVER,LANDROVER,2002,38,12,31.6,26,68.4,0,0.0
ROVER,METRO,1984,2,0,0.0,2,100.0,0,0.0
ROVER,METRO,1989,5,1,20.0,4,80.0,0,0.0
ROVER,METRO,1992,1,0,0.0,1,100.0,0,0.0
ROVER,METRO,1995,1,0,0.0,1,100.0,0,0.0
ROVER,MG,1994,1,0,0.0,1,100.0,0,0.0
ROVER,MG,1996,2,0,0.0,2,100.0,0,0.0
ROVER,MG,1997,2,0,0.0,2,100.0,0,0.0
ROVER,MG,1998,3,1,33.3,2,66.7,0,0.0
ROVER,MG,1999,2,0,0.0,2,100.0,0,0.0
ROVER,MG,2000,1,1,100.0,0,0.0,0,0.0
ROVER,MG,2001,11,3,27.3,8,72.7,0,0.0
ROVER,MG,2002,15,6,40.0,9,60.0,0,0.0
ROVER,MG,2003,16,5,31.3,11,68.8,0,0.0
ROVER,MG,2004,38,10,26.3,28,73.7,0,0.0
ROVER,MG,2005,27,5,18.5,22,81.5,0,0.0
ROVER,MG,2006,1,0,0.0,1,100.0,0,0.0
ROVER,MG,2007,1,0,0.0,1,100.0,0,0.0
ROVER,MINI,1991,1,0,0.0,1,100.0,0,0.0
ROVER,MINI,1996,1,1,100.0,0,0.0,0,0.0
ROVER,MINI,1999,3,0,0.0,3,100.0,0,0.0
ROVER,MINI,2001,1,0,0.0,1,100.0,0,0.0
ROVER,MINI COOPER,1991,1,0,0.0,1,100.0,0,0.0
ROVER,MINI COOPER,1995,1,1,100.0,0,0.0,0,0.0
ROVER,MINI COOPER,1997,1,1,100.0,0,0.0,0,0.0
ROVER,MINI COOPER,1998,2,0,0.0,2,100.0,0,0.0
ROVER,MINI COOPER,1999,1,1,100.0,0,0.0,0,0.0
ROVER,MINI COOPER,2000,1,0,0.0,1,100.0,0,0.0
ROVER,MINI COOPER,2001,1,1,100.0,0,0.0,0,0.0
ROVER,MINI SEVEN,2000,6,1,16.7,5,83.3,0,0.0
ROVER,MINI SEVEN,2001,3,0,0.0,3,100.0,0,0.0
ROVER,MINI SEVEN,2002,1,1,100.0,0,0.0,0,0.0
ROVER,OTHER,1981,1,0,0.0,1,100.0,0,0.0
ROVER,OTHER,1982,5,2,40.0,3,60.0,0,0.0
ROVER,OTHER,1984,2,1,50.0,1,50.0,0,0.0
ROVER,OTHER,1986,2,0,0.0,2,100.0,0,0.0
ROVER,OTHER,1987,2,2,100.0,0,0.0,0,0.0
ROVER,OTHER,1989,2,1,50.0,1,50.0,0,0.0
ROVER,OTHER,1990,6,1,16.7,5,83.3,0,0.0
ROVER,OTHER,1991,4,2,50.0,2,50.0,0,0.0
ROVER,OTHER,1992,2,0,0.0,2,100.0,0,0.0
ROVER,OTHER,1993,1,0,0.0,1,100.0,0,0.0
ROVER,OTHER,1994,2,1,50.0,1,50.0,0,0.0
ROVER,OTHER,1995,12,2,16.7,10,83.3,0,0.0
ROVER,OTHER,1996,15,3,20.0,12,80.0,0,0.0
ROVER,OTHER,1997,14,5,35.7,9,64.3,0,0.0
ROVER,OTHER,1998,20,6,30.0,14,70.0,0,0.0
ROVER,OTHER,1999,3,0,0.0,3,100.0,0,0.0
ROVER,OTHER,2000,2,0,0.0,2,100.0,0,0.0
ROVER,OTHER,2001,4,1,25.0,3,75.0,0,0.0
ROVER,OTHER,2002,1,0,0.0,1,100.0,0,0.0
ROVER,OTHER,2003,3,1,33.3,2,66.7,0,0.0
ROVER,OTHER,2004,9,1,11.1,8,88.9,0,0.0
ROVER,OTHER,2005,1,0,0.0,1,100.0,0,0.0
ROVER,OTHER,2006,1,0,0.0,1,100.0,0,0.0
ROVER,P5B,1994,1,1,100.0,0,0.0,0,0.0
ROVER,RANGE ROVER,1980,3,2,66.7,1,33.3,0,0.0
ROVER,RANGE ROVER,1983,1,0,0.0,1,100.0,0,0.0
ROVER,RANGE ROVER,1995,1,0,0.0,1,100.0,0,0.0
ROVER,RANGE ROVER,1996,1,1,100.0,0,0.0,0,0.0
ROVER,RANGE ROVER,1998,3,1,33.3,2,66.7,0,0.0
ROVER,RANGE ROVER,1999,7,3,42.9,4,57.1,0,0.0
ROVER,RANGE ROVER,2000,7,1,14.3,6,85.7,0,0.0
ROVER,RANGE ROVER,2001,21,13,61.9,8,38.1,0,0.0
ROVER,RANGE ROVER,2002,4,3,75.0,1,25.0,0,0.0
ROVER,RANGE ROVER,2003,6,2,33.3,4,66.7,0,0.0
ROVER,RANGE ROVER,2004,5,2,40.0,3,60.0,0,0.0
ROVER,RANGE ROVER,2005,16,4,25.0,12,75.0,0,0.0
ROVER,RANGE ROVER,2006,12,5,41.7,7,58.3,0,0.0
ROVER,RANGE ROVER,2007,42,18,42.9,24,57.1,0,0.0
ROVER,STREETWISE,2003,1,0,0.0,1,100.0,0,0.0
ROVER,STREETWISE,2004,24,6,25.0,18,75.0,0,0.0
ROVER,STREETWISE,2005,9,2,22.2,7,77.8,0,0.0
SAAB,900,1988,1,0,0.0,1,100.0,0,0.0
SAAB,900,1993,2,0,0.0,2,100.0,0,0.0
SAAB,900,1997,1,0,0.0,1,100.0,0,0.0
SAAB,9000,1999,1,1,100.0,0,0.0,0,0.0
SAAB,09-Mar,1998,17,8,47.1,9,52.9,0,0.0
SAAB,09-Mar,1999,32,14,43.8,18,56.3,0,0.0
SAAB,09-Mar,2000,87,37,42.5,50,57.5,0,0.0
SAAB,09-Mar,2001,111,62,55.9,49,44.1,0,0.0
SAAB,09-Mar,2002,109,67,61.5,42,38.5,0,0.0
SAAB,09-Mar,2003,164,70,42.7,94,57.3,0,0.0
SAAB,09-Mar,2004,419,182,43.4,237,56.6,1,0.2
SAAB,09-Mar,2005,837,310,37.0,527,63.0,0,0.0
SAAB,09-Mar,2006,876,363,41.4,513,58.6,1,0.1
SAAB,09-Mar,2007,702,354,50.4,348,49.6,1,0.1
SAAB,09-Mar,2008,754,393,52.1,361,47.9,0,0.0
SAAB,09-Mar,2009,146,63,43.2,83,56.8,0,0.0
SAAB,09-Mar,2010,174,115,66.1,59,33.9,0,0.0
SAAB,09-Mar,2011,101,72,71.3,29,28.7,0,0.0
SAAB,09-Mar,2012,4,2,50.0,2,50.0,0,0.0
SAAB,09-Mar,2016,2,2,100.0,0,0.0,0,0.0
SAAB,09-May,1998,3,1,33.3,2,66.7,0,0.0
SAAB,09-May,1999,12,7,58.3,5,41.7,0,0.0
SAAB,09-May,2000,15,3,20.0,12,80.0,0,0.0
SAAB,09-May,2001,16,6,37.5,10,62.5,0,0.0
SAAB,09-May,2002,35,19,54.3,16,45.7,0,0.0
SAAB,09-May,2003,62,32,51.6,30,48.4,0,0.0
SAAB,09-May,2004,96,45,46.9,51,53.1,0,0.0
SAAB,09-May,2005,108,55,50.9,53,49.1,0,0.0
SAAB,09-May,2006,228,109,47.8,119,52.2,0,0.0
SAAB,09-May,2007,285,145,50.9,140,49.1,1,0.4
SAAB,09-May,2008,86,38,44.2,48,55.8,0,0.0
SAAB,09-May,2009,6,1,16.7,5,83.3,0,0.0
SAAB,09-May,2010,46,31,67.4,15,32.6,0,0.0
SAAB,09-May,2011,35,17,48.6,18,51.4,0,0.0
SAAB,09-May,2012,8,6,75.0,2,25.0,0,0.0
SAAB,09-May,2013,1,0,0.0,1,100.0,0,0.0
SAAB,OTHER,1982,1,0,0.0,1,100.0,0,0.0
SAAB,OTHER,1983,1,1,100.0,0,0.0,0,0.0
SAAB,OTHER,1984,7,2,28.6,5,71.4,0,0.0
SAAB,OTHER,1985,1,1,100.0,0,0.0,0,0.0
SAAB,OTHER,1986,3,2,66.7,1,33.3,0,0.0
SAAB,OTHER,1987,6,0,0.0,6,100.0,0,0.0
SAAB,OTHER,1988,6,3,50.0,3,50.0,0,0.0
SAAB,OTHER,1989,4,2,50.0,2,50.0,0,0.0
SAAB,OTHER,1990,7,2,28.6,5,71.4,0,0.0
SAAB,OTHER,1991,11,3,27.3,8,72.7,0,0.0
SAAB,OTHER,1992,14,4,28.6,10,71.4,0,0.0
SAAB,OTHER,1993,14,5,35.7,9,64.3,0,0.0
SAAB,OTHER,1994,4,0,0.0,4,100.0,0,0.0
SAAB,OTHER,1995,7,5,71.4,2,28.6,0,0.0
SAAB,OTHER,1996,6,3,50.0,3,50.0,0,0.0
SAAB,OTHER,1997,16,5,31.3,11,68.8,0,0.0
SAAB,OTHER,1998,12,5,41.7,7,58.3,0,0.0
SAAB,OTHER,1999,1,1,100.0,0,0.0,0,0.0
SAAB,OTHER,2000,12,5,41.7,7,58.3,0,0.0
SAAB,OTHER,2001,9,6,66.7,3,33.3,0,0.0
SAAB,OTHER,2002,1,0,0.0,1,100.0,0,0.0
SEAT,ALHAMBRA,1999,1,1,100.0,0,0.0,0,0.0
SEAT,ALHAMBRA,2000,4,1,25.0,3,75.0,0,0.0
SEAT,ALHAMBRA,2001,40,4,10.0,36,90.0,0,0.0
SEAT,ALHAMBRA,2002,95,19,20.0,76,80.0,0,0.0
SEAT,ALHAMBRA,2003,152,31,20.4,121,79.6,0,0.0
SEAT,ALHAMBRA,2004,242,57,23.6,185,76.4,0,0.0
SEAT,ALHAMBRA,2005,272,52,19.1,220,80.9,0,0.0
SEAT,ALHAMBRA,2006,285,73,25.6,212,74.4,0,0.0
SEAT,ALHAMBRA,2007,236,79,33.5,157,66.5,2,0.8
SEAT,ALHAMBRA,2008,131,41,31.3,90,68.7,0,0.0
SEAT,ALHAMBRA,2009,19,7,36.8,12,63.2,0,0.0
SEAT,ALHAMBRA,2010,56,29,51.8,27,48.2,0,0.0
SEAT,ALHAMBRA,2011,17,13,76.5,4,23.5,0,0.0
SEAT,ALHAMBRA,2012,89,64,71.9,25,28.1,0,0.0
SEAT,ALHAMBRA,2013,24,15,62.5,9,37.5,0,0.0
SEAT,ALHAMBRA,2014,144,120,83.3,24,16.7,0,0.0
SEAT,ALHAMBRA,2015,22,16,72.7,6,27.3,0,0.0
SEAT,ALHAMBRA,2016,1,1,100.0,0,0.0,0,0.0
SEAT,ALHAMBRA,2017,1,1,100.0,0,0.0,0,0.0
SEAT,ALTEA,2004,102,24,23.5,78,76.5,0,0.0
SEAT,ALTEA,2005,249,65,26.1,184,73.9,0,0.0
SEAT,ALTEA,2006,127,43,33.9,84,66.1,0,0.0
SEAT,ALTEA,2007,285,117,41.1,168,58.9,0,0.0
SEAT,ALTEA,2008,135,54,40.0,81,60.0,0,0.0
SEAT,ALTEA,2009,30,18,60.0,12,40.0,0,0.0
SEAT,ALTEA,2010,77,45,58.4,32,41.6,0,0.0
SEAT,ALTEA,2011,31,20,64.5,11,35.5,0,0.0
SEAT,ALTEA,2012,81,58,71.6,23,28.4,0,0.0
SEAT,ALTEA,2013,17,15,88.2,2,11.8,0,0.0
SEAT,ALTEA,2014,66,57,86.4,9,13.6,0,0.0
SEAT,ALTEA,2015,18,17,94.4,1,5.6,0,0.0
SEAT,ALTEA XL,2007,1,0,0.0,1,100.0,0,0.0
SEAT,AROSA,1997,3,1,33.3,2,66.7,0,0.0
SEAT,AROSA,1998,32,6,18.8,26,81.3,0,0.0
SEAT,AROSA,1999,48,13,27.1,35,72.9,0,0.0
SEAT,AROSA,2000,73,37,50.7,36,49.3,0,0.0
SEAT,AROSA,2001,18,9,50.0,9,50.0,0,0.0
SEAT,AROSA,2002,42,17,40.5,25,59.5,0,0.0
SEAT,AROSA,2003,29,11,37.9,18,62.1,0,0.0
SEAT,AROSA,2004,25,11,44.0,14,56.0,0,0.0
SEAT,AROSA,2005,2,0,0.0,2,100.0,0,0.0
SEAT,AROSA,2006,1,1,100.0,0,0.0,0,0.0
SEAT,CORDOBA,1995,2,0,0.0,2,100.0,0,0.0
SEAT,CORDOBA,1996,2,1,50.0,1,50.0,0,0.0
SEAT,CORDOBA,1997,9,3,33.3,6,66.7,0,0.0
SEAT,CORDOBA,1998,12,3,25.0,9,75.0,0,0.0
SEAT,CORDOBA,1999,19,9,47.4,10,52.6,0,0.0
SEAT,CORDOBA,2000,39,21,53.8,18,46.2,0,0.0
SEAT,CORDOBA,2001,46,15,32.6,31,67.4,0,0.0
SEAT,CORDOBA,2002,37,10,27.0,27,73.0,0,0.0
SEAT,CORDOBA,2003,285,72,25.3,213,74.7,0,0.0
SEAT,CORDOBA,2004,391,116,29.7,275,70.3,0,0.0
SEAT,CORDOBA,2005,550,140,25.5,410,74.5,1,0.2
SEAT,CORDOBA,2006,418,121,28.9,297,71.1,0,0.0
SEAT,CORDOBA,2007,403,141,35.0,262,65.0,0,0.0
SEAT,CORDOBA,2008,247,76,30.8,171,69.2,1,0.4
SEAT,CORDOBA,2009,49,16,32.7,33,67.3,0,0.0
SEAT,CORDOBA,2010,61,23,37.7,38,62.3,0,0.0
SEAT,CORDOBA 1.4 S 4DR,2003,1,0,0.0,1,100.0,0,0.0
SEAT,EXEO,2009,14,7,50.0,7,50.0,0,0.0
SEAT,EXEO,2010,161,102,63.4,59,36.6,0,0.0
SEAT,EXEO,2011,34,19,55.9,15,44.1,0,0.0
SEAT,EXEO,2012,56,41,73.2,15,26.8,0,0.0
SEAT,EXEO,2013,24,17,70.8,7,29.2,0,0.0
SEAT,IBIZA,1995,5,4,80.0,1,20.0,0,0.0
SEAT,IBIZA,1996,6,3,50.0,3,50.0,0,0.0
SEAT,IBIZA,1997,23,8,34.8,15,65.2,0,0.0
SEAT,IBIZA,1998,27,10,37.0,17,63.0,0,0.0
SEAT,IBIZA,1999,37,9,24.3,28,75.7,0,0.0
SEAT,IBIZA,2000,150,49,32.7,101,67.3,0,0.0
SEAT,IBIZA,2001,173,73,42.2,100,57.8,0,0.0
SEAT,IBIZA,2002,239,69,28.9,170,71.1,0,0.0
SEAT,IBIZA,2003,605,204,33.7,401,66.3,0,0.0
SEAT,IBIZA,2004,756,230,30.4,526,69.6,0,0.0
SEAT,IBIZA,2005,744,235,31.6,509,68.4,0,0.0
SEAT,IBIZA,2006,770,286,37.1,484,62.9,0,0.0
SEAT,IBIZA,2007,883,356,40.3,527,59.7,3,0.3
SEAT,IBIZA,2008,505,237,46.9,268,53.1,0,0.0
SEAT,IBIZA,2009,166,91,54.8,75,45.2,0,0.0
SEAT,IBIZA,2010,904,594,65.7,310,34.3,1,0.1
SEAT,IBIZA,2011,210,138,65.7,72,34.3,0,0.0
SEAT,IBIZA,2012,811,601,74.1,210,25.9,0,0.0
SEAT,IBIZA,2013,149,104,69.8,45,30.2,0,0.0
SEAT,IBIZA,2014,728,604,83.0,124,17.0,0,0.0
SEAT,IBIZA,2015,63,53,84.1,10,15.9,0,0.0
SEAT,IBIZA,2016,1,1,100.0,0,0.0,0,0.0
SEAT,LEON,2000,51,13,25.5,38,74.5,0,0.0
SEAT,LEON,2001,127,59,46.5,68,53.5,0,0.0
SEAT,LEON,2002,184,58,31.5,126,68.5,0,0.0
SEAT,LEON,2003,193,55,28.5,138,71.5,0,0.0
SEAT,LEON,2004,305,99,32.5,206,67.5,0,0.0
SEAT,LEON,2005,313,96,30.7,217,69.3,0,0.0
SEAT,LEON,2006,898,330,36.7,568,63.3,0,0.0
SEAT,LEON,2007,970,447,46.1,523,53.9,0,0.0
SEAT,LEON,2008,678,319,47.1,359,52.9,0,0.0
SEAT,LEON,2009,144,66,45.8,78,54.2,1,0.7
SEAT,LEON,2010,530,315,59.4,215,40.6,0,0.0
SEAT,LEON,2011,165,108,65.5,57,34.5,0,0.0
SEAT,LEON,2012,436,313,71.8,123,28.2,0,0.0
SEAT,LEON,2013,146,103,70.5,43,29.5,0,0.0
SEAT,LEON,2014,942,761,80.8,181,19.2,0,0.0
SEAT,LEON,2015,100,82,82.0,18,18.0,0,0.0
SEAT,LEON,2016,1,0,0.0,1,100.0,0,0.0
SEAT,LEON 1.3 S 16V 5DR,2004,1,1,100.0,0,0.0,0,0.0
SEAT,MII,2012,64,51,79.7,13,20.3,0,0.0
SEAT,MII,2013,37,27,73.0,10,27.0,0,0.0
SEAT,MII,2014,247,202,81.8,45,18.2,0,0.0
SEAT,MII,2015,30,27,90.0,3,10.0,0,0.0
SEAT,OTHER,1998,3,2,66.7,1,33.3,0,0.0
SEAT,OTHER,1999,8,1,12.5,7,87.5,0,0.0
SEAT,OTHER,2000,19,4,21.1,15,78.9,0,0.0
SEAT,OTHER,2001,3,0,0.0,3,100.0,0,0.0
SEAT,OTHER,2002,2,1,50.0,1,50.0,0,0.0
SEAT,OTHER,2010,1,0,0.0,1,100.0,0,0.0
SEAT,STELLA LHD,2009,11,3,27.3,8,72.7,0,0.0
SEAT,STELLA LHD,2010,38,29,76.3,9,23.7,0,0.0
SEAT,STELLA LHD,2011,14,6,42.9,8,57.1,0,0.0
SEAT,STELLA LHD,2012,14,9,64.3,5,35.7,0,0.0
SEAT,STELLA LHD,2013,2,2,100.0,0,0.0,0,0.0
SEAT,TOLEDO,1997,1,0,0.0,1,100.0,0,0.0
SEAT,TOLEDO,1998,1,0,0.0,1,100.0,0,0.0
SEAT,TOLEDO,1999,18,6,33.3,12,66.7,0,0.0
SEAT,TOLEDO,2000,43,14,32.6,29,67.4,0,0.0
SEAT,TOLEDO,2001,56,16,28.6,40,71.4,0,0.0
SEAT,TOLEDO,2002,80,30,37.5,50,62.5,0,0.0
SEAT,TOLEDO,2003,97,23,23.7,74,76.3,0,0.0
SEAT,TOLEDO,2004,163,43,26.4,120,73.6,0,0.0
SEAT,TOLEDO,2005,218,61,28.0,157,72.0,0,0.0
SEAT,TOLEDO,2006,151,50,33.1,101,66.9,0,0.0
SEAT,TOLEDO,2007,64,19,29.7,45,70.3,0,0.0
SEAT,TOLEDO,2008,3,1,33.3,2,66.7,0,0.0
SEAT,TOLEDO,2012,16,12,75.0,4,25.0,0,0.0
SEAT,TOLEDO,2013,62,37,59.7,25,40.3,0,0.0
SEAT,TOLEDO,2014,267,205,76.8,62,23.2,0,0.0
SEAT,TOLEDO,2015,46,42,91.3,4,8.7,0,0.0
SHELSLEY,T2 KITCAR 2DR,2006,1,0,0.0,1,100.0,0,0.0
SKODA,CITIGO,2012,104,91,87.5,13,12.5,0,0.0
SKODA,CITIGO,2013,47,42,89.4,5,10.6,0,0.0
SKODA,CITIGO,2014,303,268,88.4,35,11.6,0,0.0
SKODA,CITIGO,2015,31,30,96.8,1,3.2,0,0.0
SKODA,FABIA,2000,74,31,41.9,43,58.1,0,0.0
SKODA,FABIA,2001,244,77,31.6,167,68.4,0,0.0
SKODA,FABIA,2002,321,103,32.1,218,67.9,0,0.0
SKODA,FABIA,2003,491,165,33.6,326,66.4,0,0.0
SKODA,FABIA,2004,678,204,30.1,474,69.9,0,0.0
SKODA,FABIA,2005,747,284,38.0,463,62.0,0,0.0
SKODA,FABIA,2006,868,390,44.9,478,55.1,2,0.2
SKODA,FABIA,2007,854,388,45.4,466,54.6,0,0.0
SKODA,FABIA,2008,568,293,51.6,275,48.4,0,0.0
SKODA,FABIA,2009,251,147,58.6,104,41.4,0,0.0
SKODA,FABIA,2010,928,679,73.2,249,26.8,0,0.0
SKODA,FABIA,2011,159,125,78.6,34,21.4,0,0.0
SKODA,FABIA,2012,788,646,82.0,142,18.0,0,0.0
SKODA,FABIA,2013,110,86,78.2,24,21.8,0,0.0
SKODA,FABIA,2014,649,560,86.3,89,13.7,1,0.2
SKODA,FABIA,2015,77,68,88.3,9,11.7,0,0.0
SKODA,FABIA 1.9 ELEGANCE TDI 5DR,2005,1,0,0.0,1,100.0,0,0.0
SKODA,FABIA CLASSIC,2004,1,0,0.0,1,100.0,0,0.0
SKODA,FABIA CLASSIC,2009,1,1,100.0,0,0.0,0,0.0
SKODA,FABIA CLASSIC,2010,4,2,50.0,2,50.0,0,0.0
SKODA,FELICIA,1996,3,2,66.7,1,33.3,0,0.0
SKODA,FELICIA,1997,1,0,0.0,1,100.0,0,0.0
SKODA,FELICIA,1998,17,6,35.3,11,64.7,0,0.0
SKODA,FELICIA,1999,28,9,32.1,19,67.9,0,0.0
SKODA,FELICIA,2000,23,7,30.4,16,69.6,0,0.0
SKODA,KODIAQ,2017,1,1,100.0,0,0.0,0,0.0
SKODA,KODIAQ,2018,2,2,100.0,0,0.0,0,0.0
SKODA,OCTAVIA,1998,4,1,25.0,3,75.0,0,0.0
SKODA,OCTAVIA,1999,67,19,28.4,48,71.6,0,0.0
SKODA,OCTAVIA,2000,184,66,35.9,118,64.1,0,0.0
SKODA,OCTAVIA,2001,333,94,28.2,239,71.8,0,0.0
SKODA,OCTAVIA,2002,680,228,33.5,452,66.5,0,0.0
SKODA,OCTAVIA,2003,854,285,33.4,569,66.6,0,0.0
SKODA,OCTAVIA,2004,1213,383,31.6,830,68.4,1,0.1
SKODA,OCTAVIA,2005,2978,969,32.5,2009,67.5,1,0.0
SKODA,OCTAVIA,2006,3358,1151,34.3,2207,65.7,0,0.0
SKODA,OCTAVIA,2007,3849,1664,43.2,2185,56.8,0,0.0
SKODA,OCTAVIA,2008,2417,1041,43.1,1376,56.9,0,0.0
SKODA,OCTAVIA,2009,1021,453,44.4,568,55.6,0,0.0
SKODA,OCTAVIA,2010,2914,1848,63.4,1066,36.6,1,0.0
SKODA,OCTAVIA,2011,704,434,61.6,270,38.4,1,0.1
SKODA,OCTAVIA,2012,2510,1819,72.5,691,27.5,1,0.0
SKODA,OCTAVIA,2013,608,458,75.3,150,24.7,1,0.2
SKODA,OCTAVIA,2014,3265,2804,85.9,461,14.1,1,0.0
SKODA,OCTAVIA,2015,547,471,86.1,76,13.9,1,0.2
SKODA,OCTAVIA,2016,160,133,83.1,27,16.9,0,0.0
SKODA,OCTAVIA,2017,70,67,95.7,3,4.3,0,0.0
SKODA,OCTAVIA,2018,17,16,94.1,1,5.9,0,0.0
SKODA,OCTAVIA RS,2014,2,2,100.0,0,0.0,0,0.0
SKODA,OCTAVIA VRS 5DR,2001,1,0,0.0,1,100.0,0,0.0
SKODA,OTHER,1995,2,1,50.0,1,50.0,0,0.0
SKODA,OTHER,1996,1,0,0.0,1,100.0,0,0.0
SKODA,OTHER,1997,15,8,53.3,7,46.7,0,0.0
SKODA,OTHER,1998,6,3,50.0,3,50.0,0,0.0
SKODA,OTHER,2000,5,3,60.0,2,40.0,0,0.0
SKODA,OTHER,2001,11,2,18.2,9,81.8,0,0.0
SKODA,OTHER,2002,18,6,33.3,12,66.7,0,0.0
SKODA,OTHER,2003,81,29,35.8,52,64.2,0,0.0
SKODA,OTHER,2004,30,9,30.0,21,70.0,0,0.0
SKODA,OTHER,2006,2,0,0.0,2,100.0,0,0.0
SKODA,OTHER,2007,9,5,55.6,4,44.4,0,0.0
SKODA,OTHER,2008,2,1,50.0,1,50.0,0,0.0
SKODA,OTHER,2014,1,0,0.0,1,100.0,0,0.0
SKODA,RAPID,2012,24,20,83.3,4,16.7,1,4.2
SKODA,RAPID,2013,121,96,79.3,25,20.7,0,0.0
SKODA,RAPID,2014,718,619,86.2,99,13.8,0,0.0
SKODA,RAPID,2015,71,57,80.3,14,19.7,0,0.0
SKODA,RAPID,2016,1,1,100.0,0,0.0,0,0.0
SKODA,ROOMSTER,2006,25,12,48.0,13,52.0,0,0.0
SKODA,ROOMSTER,2007,232,96,41.4,136,58.6,0,0.0
SKODA,ROOMSTER,2008,73,34,46.6,39,53.4,0,0.0
SKODA,ROOMSTER,2009,21,12,57.1,9,42.9,0,0.0
SKODA,ROOMSTER,2010,17,12,70.6,5,29.4,0,0.0
SKODA,ROOMSTER,2011,13,10,76.9,3,23.1,0,0.0
SKODA,ROOMSTER,2012,83,69,83.1,14,16.9,0,0.0
SKODA,ROOMSTER,2013,11,9,81.8,2,18.2,0,0.0
SKODA,ROOMSTER,2014,74,62,83.8,12,16.2,1,1.4
SKODA,ROOMSTER,2015,7,7,100.0,0,0.0,0,0.0
SKODA,SUPERB,2002,10,6,60.0,4,40.0,0,0.0
SKODA,SUPERB,2003,56,9,16.1,47,83.9,0,0.0
SKODA,SUPERB,2004,192,70,36.5,122,63.5,0,0.0
SKODA,SUPERB,2005,426,140,32.9,286,67.1,1,0.2
SKODA,SUPERB,2006,419,143,34.1,276,65.9,0,0.0
SKODA,SUPERB,2007,450,169,37.6,281,62.4,2,0.4
SKODA,SUPERB,2008,274,103,37.6,171,62.4,1,0.4
SKODA,SUPERB,2009,432,176,40.7,256,59.3,0,0.0
SKODA,SUPERB,2010,1146,642,56.0,504,44.0,0,0.0
SKODA,SUPERB,2011,375,249,66.4,126,33.6,0,0.0
SKODA,SUPERB,2012,1219,938,76.9,281,23.1,1,0.1
SKODA,SUPERB,2013,409,325,79.5,84,20.5,1,0.2
SKODA,SUPERB,2014,1275,1064,83.5,211,16.5,1,0.1
SKODA,SUPERB,2015,351,308,87.7,43,12.3,0,0.0
SKODA,SUPERB,2016,172,159,92.4,13,7.6,0,0.0
SKODA,SUPERB,2017,107,99,92.5,8,7.5,0,0.0
SKODA,SUPERB,2018,23,23,100.0,0,0.0,0,0.0
SKODA,YETI,2009,1,1,100.0,0,0.0,0,0.0
SKODA,YETI,2010,440,315,71.6,125,28.4,0,0.0
SKODA,YETI,2011,70,50,71.4,20,28.6,1,1.4
SKODA,YETI,2012,465,392,84.3,73,15.7,1,0.2
SKODA,YETI,2013,85,71,83.5,14,16.5,0,0.0
SKODA,YETI,2014,376,333,88.6,43,11.4,0,0.0
SKODA,YETI,2015,55,50,90.9,5,9.1,0,0.0
SKODA,YETI OUTDOOR,2013,2,1,50.0,1,50.0,0,0.0
SKODA,YETI OUTDOOR,2014,42,36,85.7,6,14.3,0,0.0
SKODA,YETI OUTDOOR,2015,2,2,100.0,0,0.0,0,0.0
SMART,CABRIO,2004,4,3,75.0,1,25.0,0,0.0
SMART,CABRIO,2006,4,1,25.0,3,75.0,0,0.0
SMART,CITY,2003,6,3,50.0,3,50.0,0,0.0
SMART,CITY,2004,20,10,50.0,10,50.0,0,0.0
SMART,CITY,2005,11,6,54.5,5,45.5,0,0.0
SMART,CITY,2006,1,0,0.0,1,100.0,0,0.0
SMART,FORFOUR,2004,4,2,50.0,2,50.0,0,0.0
SMART,FORFOUR,2005,14,8,57.1,6,42.9,0,0.0
SMART,FORFOUR,2006,12,5,41.7,7,58.3,0,0.0
SMART,FORFOUR,2007,2,0,0.0,2,100.0,0,0.0
SMART,OTHER,1998,1,1,100.0,0,0.0,0,0.0
SMART,OTHER,1999,2,2,100.0,0,0.0,0,0.0
SMART,OTHER,2000,5,1,20.0,4,80.0,0,0.0
SMART,OTHER,2001,3,0,0.0,3,100.0,0,0.0
SMART,OTHER,2002,12,7,58.3,5,41.7,0,0.0
SMART,OTHER,2003,58,21,36.2,37,63.8,0,0.0
SMART,OTHER,2004,84,39,46.4,45,53.6,0,0.0
SMART,OTHER,2005,62,27,43.5,35,56.5,0,0.0
SMART,OTHER,2006,39,26,66.7,13,33.3,0,0.0
SMART,OTHER,2007,34,25,73.5,9,26.5,0,0.0
SMART,OTHER,2008,32,18,56.3,14,43.8,0,0.0
SMART,OTHER,2009,16,9,56.3,7,43.8,0,0.0
SMART,OTHER,2010,25,14,56.0,11,44.0,0,0.0
SMART,OTHER,2011,3,2,66.7,1,33.3,0,0.0
SMART,OTHER,2012,17,14,82.4,3,17.6,0,0.0
SMART,OTHER,2013,5,5,100.0,0,0.0,0,0.0
SMART,OTHER,2014,13,12,92.3,1,7.7,0,0.0
SMART,ROADSTER,2003,1,1,100.0,0,0.0,0,0.0
SMART,ROADSTER,2004,6,2,33.3,4,66.7,0,0.0
SMART,ROADSTER,2005,6,2,33.3,4,66.7,0,0.0
SSANGYONG,ACTYON,2007,49,10,20.4,39,79.6,0,0.0
SSANGYONG,ACTYON,2008,8,0,0.0,8,100.0,0,0.0
SSANGYONG,ACTYON,2009,2,1,50.0,1,50.0,0,0.0
SSANGYONG,KORANDO,2012,2,1,50.0,1,50.0,0,0.0
SSANGYONG,KORANDO,2013,3,2,66.7,1,33.3,0,0.0
SSANGYONG,KORANDO,2014,61,37,60.7,24,39.3,0,0.0
SSANGYONG,KORANDO,2015,8,7,87.5,1,12.5,0,0.0
SSANGYONG,KYRON,2006,86,11,12.8,75,87.2,0,0.0
SSANGYONG,KYRON,2007,121,23,19.0,98,81.0,1,0.8
SSANGYONG,KYRON,2008,20,5,25.0,15,75.0,0,0.0
SSANGYONG,KYRON,2010,4,1,25.0,3,75.0,0,0.0
SSANGYONG,REXTON,2005,5,0,0.0,5,100.0,0,0.0
SSANGYONG,REXTON,2006,11,1,9.1,10,90.9,0,0.0
SSANGYONG,REXTON,2007,25,2,8.0,23,92.0,0,0.0
SSANGYONG,REXTON,2008,3,2,66.7,1,33.3,0,0.0
SSANGYONG,REXTON,2009,1,0,0.0,1,100.0,0,0.0
SSANGYONG,REXTON,2014,2,2,100.0,0,0.0,0,0.0
SSANGYONG,REXTON,2015,1,1,100.0,0,0.0,0,0.0
SSANGYONG,RODIUS,2005,1,0,0.0,1,100.0,0,0.0
SSANGYONG,RODIUS,2006,47,5,10.6,42,89.4,0,0.0
SSANGYONG,RODIUS,2007,40,7,17.5,33,82.5,0,0.0
SSANGYONG,RODIUS,2008,33,8,24.2,25,75.8,0,0.0
SSANGYONG,RODIUS,2009,8,0,0.0,8,100.0,0,0.0
SSANGYONG,RODIUS,2010,14,4,28.6,10,71.4,0,0.0
SSANGYONG,RODIUS,2011,3,0,0.0,3,100.0,0,0.0
SSANGYONG,RODIUS,2012,7,3,42.9,4,57.1,0,0.0
SSANGYONG,RODIUS,2013,7,2,28.6,5,71.4,0,0.0
SSANGYONG,RODIUS,2014,23,12,52.2,11,47.8,0,0.0
SSANGYONG,RODIUS,2015,4,1,25.0,3,75.0,0,0.0
SSANGYONG,RODIUS,2016,7,4,57.1,3,42.9,0,0.0
SSANGYONG,RODIUS,2017,2,2,100.0,0,0.0,0,0.0
SSANGYONG,RODIUS,2018,1,1,100.0,0,0.0,0,0.0
SSANGYONG,TURISMO,2013,1,0,0.0,1,100.0,0,0.0
SSANGYONG,TURISMO,2014,4,3,75.0,1,25.0,0,0.0
SSANGYONG,TURISMO,2015,3,0,0.0,3,100.0,0,0.0
SSANGYONG,TURISMO,2016,1,1,100.0,0,0.0,0,0.0
SUBARU,BRZ,2012,1,0,0.0,1,100.0,0,0.0
SUBARU,BRZ,2014,2,2,100.0,0,0.0,0,0.0
SUBARU,FORESTER,1997,1,0,0.0,1,100.0,0,0.0
SUBARU,FORESTER,1998,4,3,75.0,1,25.0,0,0.0
SUBARU,FORESTER,1999,20,9,45.0,11,55.0,0,0.0
SUBARU,FORESTER,2000,25,9,36.0,16,64.0,0,0.0
SUBARU,FORESTER,2001,29,9,31.0,20,69.0,0,0.0
SUBARU,FORESTER,2002,20,7,35.0,13,65.0,0,0.0
SUBARU,FORESTER,2003,76,44,57.9,32,42.1,0,0.0
SUBARU,FORESTER,2004,74,35,47.3,39,52.7,0,0.0
SUBARU,FORESTER,2005,88,45,51.1,43,48.9,1,1.1
SUBARU,FORESTER,2006,120,58,48.3,62,51.7,0,0.0
SUBARU,FORESTER,2007,69,37,53.6,32,46.4,0,0.0
SUBARU,FORESTER,2008,19,11,57.9,8,42.1,0,0.0
SUBARU,FORESTER,2009,26,15,57.7,11,42.3,0,0.0
SUBARU,FORESTER,2010,51,33,64.7,18,35.3,1,2.0
SUBARU,FORESTER,2011,9,8,88.9,1,11.1,0,0.0
SUBARU,FORESTER,2012,40,27,67.5,13,32.5,0,0.0
SUBARU,FORESTER,2013,3,2,66.7,1,33.3,0,0.0
SUBARU,FORESTER,2014,61,47,77.0,14,23.0,1,1.6
SUBARU,FORESTER,2015,8,8,100.0,0,0.0,0,0.0
SUBARU,GT SERIES II,1999,4,4,100.0,0,0.0,0,0.0
SUBARU,IMPREZA,1993,4,1,25.0,3,75.0,0,0.0
SUBARU,IMPREZA,1994,9,4,44.4,5,55.6,0,0.0
SUBARU,IMPREZA,1995,21,9,42.9,12,57.1,1,4.8
SUBARU,IMPREZA,1996,15,5,33.3,10,66.7,0,0.0
SUBARU,IMPREZA,1997,37,14,37.8,23,62.2,0,0.0
SUBARU,IMPREZA,1998,76,27,35.5,49,64.5,0,0.0
SUBARU,IMPREZA,1999,64,27,42.2,37,57.8,2,3.1
SUBARU,IMPREZA,2000,98,35,35.7,63,64.3,0,0.0
SUBARU,IMPREZA,2001,65,21,32.3,44,67.7,0,0.0
SUBARU,IMPREZA,2002,80,33,41.3,47,58.8,1,1.3
SUBARU,IMPREZA,2003,122,38,31.1,84,68.9,0,0.0
SUBARU,IMPREZA,2004,113,45,39.8,68,60.2,0,0.0
SUBARU,IMPREZA,2005,132,50,37.9,82,62.1,1,0.8
SUBARU,IMPREZA,2006,200,86,43.0,114,57.0,1,0.5
SUBARU,IMPREZA,2007,138,65,47.1,73,52.9,2,1.4
SUBARU,IMPREZA,2008,47,21,44.7,26,55.3,0,0.0
SUBARU,IMPREZA,2009,27,11,40.7,16,59.3,0,0.0
SUBARU,IMPREZA,2010,24,18,75.0,6,25.0,0,0.0
SUBARU,IMPREZA,2011,5,4,80.0,1,20.0,0,0.0
SUBARU,IMPREZA,2012,1,1,100.0,0,0.0,0,0.0
SUBARU,IMPREZA,2014,8,6,75.0,2,25.0,0,0.0
SUBARU,IMPREZA,2015,3,3,100.0,0,0.0,0,0.0
SUBARU,IMPREZA WRX GC8*47D 4DR,2007,2,1,50.0,1,50.0,0,0.0
SUBARU,IMPREZA WRX STI TYPE UK,2003,1,1,100.0,0,0.0,0,0.0
SUBARU,JUSTY,1997,1,0,0.0,1,100.0,0,0.0
SUBARU,JUSTY,1998,3,3,100.0,0,0.0,0,0.0
SUBARU,JUSTY,1999,2,0,0.0,2,100.0,0,0.0
SUBARU,JUSTY,2007,2,1,50.0,1,50.0,0,0.0
SUBARU,JUSTY,2008,22,16,72.7,6,27.3,0,0.0
SUBARU,JUSTY,2009,3,3,100.0,0,0.0,0,0.0
SUBARU,JUSTY,2010,25,20,80.0,5,20.0,0,0.0
SUBARU,LEGACY,1989,1,1,100.0,0,0.0,0,0.0
SUBARU,LEGACY,1991,1,1,100.0,0,0.0,0,0.0
SUBARU,LEGACY,1992,3,2,66.7,1,33.3,0,0.0
SUBARU,LEGACY,1993,1,0,0.0,1,100.0,0,0.0
SUBARU,LEGACY,1994,1,1,100.0,0,0.0,0,0.0
SUBARU,LEGACY,1995,2,0,0.0,2,100.0,0,0.0
SUBARU,LEGACY,1996,3,2,66.7,1,33.3,0,0.0
SUBARU,LEGACY,1998,3,0,0.0,3,100.0,0,0.0
SUBARU,LEGACY,1999,12,5,41.7,7,58.3,0,0.0
SUBARU,LEGACY,2000,16,5,31.3,11,68.8,0,0.0
SUBARU,LEGACY,2001,19,4,21.1,15,78.9,0,0.0
SUBARU,LEGACY,2002,19,7,36.8,12,63.2,0,0.0
SUBARU,LEGACY,2003,28,8,28.6,20,71.4,0,0.0
SUBARU,LEGACY,2004,60,30,50.0,30,50.0,0,0.0
SUBARU,LEGACY,2005,81,40,49.4,41,50.6,0,0.0
SUBARU,LEGACY,2006,49,17,34.7,32,65.3,0,0.0
SUBARU,LEGACY,2007,69,31,44.9,38,55.1,2,2.9
SUBARU,LEGACY,2008,91,36,39.6,55,60.4,0,0.0
SUBARU,LEGACY,2009,23,15,65.2,8,34.8,0,0.0
SUBARU,LEGACY,2010,67,34,50.7,33,49.3,2,3.0
SUBARU,LEGACY,2011,12,6,50.0,6,50.0,0,0.0
SUBARU,LEGACY,2012,23,17,73.9,6,26.1,0,0.0
SUBARU,LEGACY,2013,5,3,60.0,2,40.0,0,0.0
SUBARU,LEGACY,2014,7,4,57.1,3,42.9,0,0.0
SUBARU,OTHER,1988,1,1,100.0,0,0.0,0,0.0
SUBARU,OTHER,1991,1,0,0.0,1,100.0,0,0.0
SUBARU,OTHER,1992,2,2,100.0,0,0.0,0,0.0
SUBARU,OTHER,1993,1,0,0.0,1,100.0,0,0.0
SUBARU,OTHER,1994,6,4,66.7,2,33.3,0,0.0
SUBARU,OTHER,1995,4,1,25.0,3,75.0,0,0.0
SUBARU,OTHER,1996,2,0,0.0,2,100.0,0,0.0
SUBARU,OTHER,1997,2,1,50.0,1,50.0,0,0.0
SUBARU,OTHER,1998,3,1,33.3,2,66.7,0,0.0
SUBARU,OTHER,1999,7,4,57.1,3,42.9,0,0.0
SUBARU,OTHER,2000,12,4,33.3,8,66.7,0,0.0
SUBARU,OTHER,2001,5,2,40.0,3,60.0,0,0.0
SUBARU,OTHER,2002,8,5,62.5,3,37.5,0,0.0
SUBARU,OTHER,2003,7,1,14.3,6,85.7,0,0.0
SUBARU,OTHER,2004,5,1,20.0,4,80.0,0,0.0
SUBARU,OTHER,2005,5,3,60.0,2,40.0,0,0.0
SUBARU,OTHER,2006,1,0,0.0,1,100.0,0,0.0
SUBARU,OTHER,2007,1,1,100.0,0,0.0,0,0.0
SUBARU,OTHER,2008,1,1,100.0,0,0.0,0,0.0
SUBARU,OTHER,2011,1,0,0.0,1,100.0,0,0.0
SUBARU,OUTBACK,2002,1,0,0.0,1,100.0,0,0.0
SUBARU,OUTBACK,2003,5,2,40.0,3,60.0,0,0.0
SUBARU,OUTBACK,2004,11,6,54.5,5,45.5,0,0.0
SUBARU,OUTBACK,2005,33,15,45.5,18,54.5,0,0.0
SUBARU,OUTBACK,2006,25,16,64.0,9,36.0,0,0.0
SUBARU,OUTBACK,2007,24,12,50.0,12,50.0,0,0.0
SUBARU,OUTBACK,2008,20,10,50.0,10,50.0,0,0.0
SUBARU,OUTBACK,2009,5,3,60.0,2,40.0,0,0.0
SUBARU,OUTBACK,2010,21,13,61.9,8,38.1,0,0.0
SUBARU,OUTBACK,2011,6,4,66.7,2,33.3,0,0.0
SUBARU,OUTBACK,2012,28,20,71.4,8,28.6,0,0.0
SUBARU,OUTBACK,2014,23,18,78.3,5,21.7,0,0.0
SUBARU,OUTBACK,2015,1,1,100.0,0,0.0,0,0.0
SUBARU,STELLA,2009,1,1,100.0,0,0.0,0,0.0
SUBARU,TRIBECA B9 3.0 SE7 5DR A,2006,2,2,100.0,0,0.0,0,0.0
SUBARU,VIVIO,1993,4,1,25.0,3,75.0,0,0.0
SUBARU,VIVIO,1994,3,1,33.3,2,66.7,0,0.0
SUBARU,VIVIO,1995,1,0,0.0,1,100.0,0,0.0
SUBARU,VIVIO,1996,6,3,50.0,3,50.0,0,0.0
SUBARU,VIVIO,1997,9,6,66.7,3,33.3,0,0.0
SUBARU,VIVIO,1998,3,2,66.7,1,33.3,0,0.0
SUBARU,VIVIO,1999,2,1,50.0,1,50.0,0,0.0
SUBARU,WRX,1994,1,1,100.0,0,0.0,0,0.0
SUBARU,XV,2012,30,21,70.0,9,30.0,0,0.0
SUBARU,XV,2013,2,1,50.0,1,50.0,0,0.0
SUBARU,XV,2014,24,22,91.7,2,8.3,0,0.0
SUBARU,XV,2015,3,3,100.0,0,0.0,0,0.0
SUZUKI,ALTO,1988,2,1,50.0,1,50.0,0,0.0
SUZUKI,ALTO,1990,3,1,33.3,2,66.7,0,0.0
SUZUKI,ALTO,1991,1,1,100.0,0,0.0,0,0.0
SUZUKI,ALTO,1995,1,1,100.0,0,0.0,0,0.0
SUZUKI,ALTO,1996,6,2,33.3,4,66.7,0,0.0
SUZUKI,ALTO,1997,16,2,12.5,14,87.5,0,0.0
SUZUKI,ALTO,1998,4,0,0.0,4,100.0,0,0.0
SUZUKI,ALTO,1999,10,4,40.0,6,60.0,0,0.0
SUZUKI,ALTO,2000,13,3,23.1,10,76.9,0,0.0
SUZUKI,ALTO,2001,6,1,16.7,5,83.3,0,0.0
SUZUKI,ALTO,2002,13,7,53.8,6,46.2,0,0.0
SUZUKI,ALTO,2003,50,12,24.0,38,76.0,0,0.0
SUZUKI,ALTO,2004,83,27,32.5,56,67.5,0,0.0
SUZUKI,ALTO,2005,42,9,21.4,33,78.6,0,0.0
SUZUKI,ALTO,2006,5,2,40.0,3,60.0,0,0.0
SUZUKI,ALTO,2007,1,0,0.0,1,100.0,0,0.0
SUZUKI,ALTO,2009,42,19,45.2,23,54.8,0,0.0
SUZUKI,ALTO,2010,134,97,72.4,37,27.6,0,0.0
SUZUKI,ALTO,2011,30,22,73.3,8,26.7,0,0.0
SUZUKI,ALTO,2012,79,52,65.8,27,34.2,0,0.0
SUZUKI,ALTO,2013,40,30,75.0,10,25.0,0,0.0
SUZUKI,ALTO,2014,130,102,78.5,28,21.5,0,0.0
SUZUKI,ALTO,2015,4,4,100.0,0,0.0,0,0.0
SUZUKI,BALENO,1996,3,1,33.3,2,66.7,0,0.0
SUZUKI,BALENO,1997,4,1,25.0,3,75.0,0,0.0
SUZUKI,BALENO,1998,6,2,33.3,4,66.7,0,0.0
SUZUKI,BALENO,1999,5,1,20.0,4,80.0,0,0.0
SUZUKI,BALENO,2000,17,6,35.3,11,64.7,0,0.0
SUZUKI,BALENO,2001,13,6,46.2,7,53.8,0,0.0
SUZUKI,BALENO,2002,13,6,46.2,7,53.8,0,0.0
SUZUKI,CAPPUCCINO,1993,1,0,0.0,1,100.0,0,0.0
SUZUKI,CAPPUCCINO,1995,1,0,0.0,1,100.0,0,0.0
SUZUKI,CELERIO,2014,4,4,100.0,0,0.0,0,0.0
SUZUKI,CELERIO,2015,13,13,100.0,0,0.0,0,0.0
SUZUKI,EVERY,2005,1,0,0.0,1,100.0,0,0.0
SUZUKI,GRAND VITARA,1999,7,3,42.9,4,57.1,0,0.0
SUZUKI,GRAND VITARA,2000,8,1,12.5,7,87.5,0,0.0
SUZUKI,GRAND VITARA,2001,51,16,31.4,35,68.6,0,0.0
SUZUKI,GRAND VITARA,2002,125,37,29.6,88,70.4,0,0.0
SUZUKI,GRAND VITARA,2003,332,136,41.0,196,59.0,0,0.0
SUZUKI,GRAND VITARA,2004,720,333,46.3,387,53.8,3,0.4
SUZUKI,GRAND VITARA,2005,765,349,45.6,416,54.4,1,0.1
SUZUKI,GRAND VITARA,2006,1079,552,51.2,527,48.8,5,0.5
SUZUKI,GRAND VITARA,2007,950,506,53.3,444,46.7,5,0.5
SUZUKI,GRAND VITARA,2008,312,184,59.0,128,41.0,0,0.0
SUZUKI,GRAND VITARA,2009,9,4,44.4,5,55.6,0,0.0
SUZUKI,GRAND VITARA,2010,19,14,73.7,5,26.3,0,0.0
SUZUKI,GRAND VITARA,2011,3,2,66.7,1,33.3,0,0.0
SUZUKI,GRAND VITARA,2012,36,25,69.4,11,30.6,0,0.0
SUZUKI,GRAND VITARA,2013,4,4,100.0,0,0.0,0,0.0
SUZUKI,GRAND VITARA 2.0 TD 5DR,2004,1,0,0.0,1,100.0,0,0.0
SUZUKI,IGNIS,2001,72,27,37.5,45,62.5,0,0.0
SUZUKI,IGNIS,2002,114,39,34.2,75,65.8,0,0.0
SUZUKI,IGNIS,2003,110,36,32.7,74,67.3,0,0.0
SUZUKI,IGNIS,2004,203,91,44.8,112,55.2,0,0.0
SUZUKI,IGNIS,2005,390,183,46.9,207,53.1,0,0.0
SUZUKI,IGNIS,2006,336,186,55.4,150,44.6,0,0.0
SUZUKI,IGNIS,2007,318,180,56.6,138,43.4,1,0.3
SUZUKI,IGNIS,2008,12,6,50.0,6,50.0,0,0.0
SUZUKI,JIMNY,1994,2,1,50.0,1,50.0,0,0.0
SUZUKI,JIMNY,1996,1,1,100.0,0,0.0,0,0.0
SUZUKI,JIMNY,1998,2,0,0.0,2,100.0,0,0.0
SUZUKI,JIMNY,1999,53,27,50.9,26,49.1,0,0.0
SUZUKI,JIMNY,2000,158,51,32.3,107,67.7,0,0.0
SUZUKI,JIMNY,2001,83,36,43.4,47,56.6,0,0.0
SUZUKI,JIMNY,2002,164,69,42.1,95,57.9,0,0.0
SUZUKI,JIMNY,2003,153,75,49.0,78,51.0,0,0.0
SUZUKI,JIMNY,2004,171,96,56.1,75,43.9,1,0.6
SUZUKI,JIMNY,2005,179,104,58.1,75,41.9,0,0.0
SUZUKI,JIMNY,2006,175,104,59.4,71,40.6,0,0.0
SUZUKI,JIMNY,2007,137,78,56.9,59,43.1,0,0.0
SUZUKI,JIMNY,2008,40,21,52.5,19,47.5,0,0.0
SUZUKI,JIMNY,2009,1,1,100.0,0,0.0,0,0.0
SUZUKI,JIMNY,2010,1,0,0.0,1,100.0,0,0.0
SUZUKI,JIMNY,2014,1,1,100.0,0,0.0,0,0.0
SUZUKI,JIMNY,2015,1,1,100.0,0,0.0,0,0.0
SUZUKI,LIANA,2001,10,3,30.0,7,70.0,0,0.0
SUZUKI,LIANA,2002,42,12,28.6,30,71.4,0,0.0
SUZUKI,LIANA,2003,211,77,36.5,134,63.5,0,0.0
SUZUKI,LIANA,2004,534,214,40.1,320,59.9,0,0.0
SUZUKI,LIANA,2005,820,383,46.7,437,53.3,0,0.0
SUZUKI,LIANA,2006,729,348,47.7,381,52.3,1,0.1
SUZUKI,LIANA,2007,118,56,47.5,62,52.5,0,0.0
SUZUKI,LIANA,2008,2,0,0.0,2,100.0,0,0.0
SUZUKI,OTHER,1986,1,0,0.0,1,100.0,0,0.0
SUZUKI,OTHER,1987,1,0,0.0,1,100.0,0,0.0
SUZUKI,OTHER,1988,1,0,0.0,1,100.0,0,0.0
SUZUKI,OTHER,1989,2,1,50.0,1,50.0,0,0.0
SUZUKI,OTHER,1990,2,0,0.0,2,100.0,0,0.0
SUZUKI,OTHER,1991,5,2,40.0,3,60.0,0,0.0
SUZUKI,OTHER,1992,11,3,27.3,8,72.7,0,0.0
SUZUKI,OTHER,1993,4,1,25.0,3,75.0,0,0.0
SUZUKI,OTHER,1994,7,3,42.9,4,57.1,0,0.0
SUZUKI,OTHER,1995,7,3,42.9,4,57.1,0,0.0
SUZUKI,OTHER,1996,12,3,25.0,9,75.0,0,0.0
SUZUKI,OTHER,1997,6,1,16.7,5,83.3,0,0.0
SUZUKI,OTHER,1998,6,5,83.3,1,16.7,0,0.0
SUZUKI,OTHER,1999,53,13,24.5,40,75.5,0,0.0
SUZUKI,OTHER,2000,111,31,27.9,80,72.1,0,0.0
SUZUKI,OTHER,2001,121,31,25.6,90,74.4,0,0.0
SUZUKI,OTHER,2002,205,64,31.2,141,68.8,0,0.0
SUZUKI,OTHER,2003,74,34,45.9,40,54.1,0,0.0
SUZUKI,OTHER,2004,24,15,62.5,9,37.5,0,0.0
SUZUKI,OTHER,2005,19,9,47.4,10,52.6,0,0.0
SUZUKI,OTHER,2006,8,3,37.5,5,62.5,0,0.0
SUZUKI,OTHER,2007,2,0,0.0,2,100.0,0,0.0
SUZUKI,OTHER,2008,1,1,100.0,0,0.0,0,0.0
SUZUKI,SPLASH,2008,51,32,62.7,19,37.3,0,0.0
SUZUKI,SPLASH,2009,48,36,75.0,12,25.0,0,0.0
SUZUKI,SPLASH,2010,42,22,52.4,20,47.6,0,0.0
SUZUKI,SPLASH,2011,19,15,78.9,4,21.1,0,0.0
SUZUKI,SPLASH,2012,28,21,75.0,7,25.0,0,0.0
SUZUKI,SPLASH,2013,16,13,81.3,3,18.8,0,0.0
SUZUKI,SPLASH,2014,46,40,87.0,6,13.0,0,0.0
SUZUKI,SPLASH,2015,3,3,100.0,0,0.0,0,0.0
SUZUKI,SWIFT,1987,3,0,0.0,3,100.0,0,0.0
SUZUKI,SWIFT,1988,1,0,0.0,1,100.0,0,0.0
SUZUKI,SWIFT,1993,1,0,0.0,1,100.0,0,0.0
SUZUKI,SWIFT,1994,2,2,100.0,0,0.0,0,0.0
SUZUKI,SWIFT,1995,2,2,100.0,0,0.0,0,0.0
SUZUKI,SWIFT,1996,4,4,100.0,0,0.0,0,0.0
SUZUKI,SWIFT,1997,12,4,33.3,8,66.7,0,0.0
SUZUKI,SWIFT,1998,17,8,47.1,9,52.9,0,0.0
SUZUKI,SWIFT,1999,24,5,20.8,19,79.2,0,0.0
SUZUKI,SWIFT,2000,52,14,26.9,38,73.1,0,0.0
SUZUKI,SWIFT,2001,50,18,36.0,32,64.0,0,0.0
SUZUKI,SWIFT,2002,34,9,26.5,25,73.5,0,0.0
SUZUKI,SWIFT,2003,14,5,35.7,9,64.3,0,0.0
SUZUKI,SWIFT,2004,8,4,50.0,4,50.0,0,0.0
SUZUKI,SWIFT,2005,224,114,50.9,110,49.1,0,0.0
SUZUKI,SWIFT,2006,1020,488,47.8,532,52.2,0,0.0
SUZUKI,SWIFT,2007,1080,547,50.6,533,49.4,1,0.1
SUZUKI,SWIFT,2008,515,268,52.0,247,48.0,0,0.0
SUZUKI,SWIFT,2009,164,88,53.7,76,46.3,0,0.0
SUZUKI,SWIFT,2010,244,154,63.1,90,36.9,0,0.0
SUZUKI,SWIFT,2011,74,56,75.7,18,24.3,0,0.0
SUZUKI,SWIFT,2012,279,211,75.6,68,24.4,0,0.0
SUZUKI,SWIFT,2013,52,41,78.8,11,21.2,0,0.0
SUZUKI,SWIFT,2014,234,204,87.2,30,12.8,0,0.0
SUZUKI,SWIFT,2015,25,23,92.0,2,8.0,0,0.0
SUZUKI,SWIFT,2016,3,3,100.0,0,0.0,0,0.0
SUZUKI,SWIFT 1.0,2001,1,0,0.0,1,100.0,0,0.0
SUZUKI,SX4,2006,58,27,46.6,31,53.4,0,0.0
SUZUKI,SX4,2007,531,277,52.2,254,47.8,0,0.0
SUZUKI,SX4,2008,508,236,46.5,272,53.5,2,0.4
SUZUKI,SX4,2009,145,88,60.7,57,39.3,0,0.0
SUZUKI,SX4,2010,216,131,60.6,85,39.4,1,0.5
SUZUKI,SX4,2011,31,15,48.4,16,51.6,0,0.0
SUZUKI,SX4,2012,198,149,75.3,49,24.7,0,0.0
SUZUKI,SX4,2013,29,21,72.4,8,27.6,0,0.0
SUZUKI,SX4,2014,299,250,83.6,49,16.4,0,0.0
SUZUKI,SX4,2015,32,28,87.5,4,12.5,0,0.0
SUZUKI,VITARA,1993,2,2,100.0,0,0.0,0,0.0
SUZUKI,VITARA,1995,2,0,0.0,2,100.0,0,0.0
SUZUKI,VITARA,1996,2,0,0.0,2,100.0,0,0.0
SUZUKI,VITARA,1997,6,3,50.0,3,50.0,0,0.0
SUZUKI,VITARA,1998,3,0,0.0,3,100.0,0,0.0
SUZUKI,VITARA,2000,2,1,50.0,1,50.0,0,0.0
SUZUKI,VITARA,2003,1,0,0.0,1,100.0,0,0.0
SUZUKI,VITARA,2004,23,14,60.9,9,39.1,0,0.0
SUZUKI,VITARA,2005,31,22,71.0,9,29.0,0,0.0
SUZUKI,VITARA,2006,2,1,50.0,1,50.0,0,0.0
SUZUKI,VITARA,2015,3,2,66.7,1,33.3,0,0.0
SUZUKI,WAGON,1998,16,4,25.0,12,75.0,0,0.0
SUZUKI,WAGON,1999,11,5,45.5,6,54.5,0,0.0
SUZUKI,WAGON,2000,34,10,29.4,24,70.6,0,0.0
SUZUKI,WAGON,2001,36,11,30.6,25,69.4,0,0.0
SUZUKI,WAGON,2002,56,24,42.9,32,57.1,0,0.0
SUZUKI,WAGON,2003,83,22,26.5,61,73.5,0,0.0
SUZUKI,WAGON,2004,88,39,44.3,49,55.7,0,0.0
SUZUKI,WAGON,2005,59,28,47.5,31,52.5,0,0.0
SUZUKI,WAGON,2006,6,5,83.3,1,16.7,0,0.0
SUZUKI,WAGON,2007,1,1,100.0,0,0.0,0,0.0
SUZUKI,WAGON,2008,1,0,0.0,1,100.0,0,0.0
SUZUKI,WAGON-R + 1.3 LHD,2003,1,1,100.0,0,0.0,0,0.0
SUZUKI,WAGON-R + 1.3 LHD,2006,1,1,100.0,0,0.0,0,0.0
SUZUKI,WAGON-R + 1.3 LHD,2011,1,0,0.0,1,100.0,0,0.0
TALBOT,SAMBA,1983,1,1,100.0,0,0.0,0,0.0
TATA,SAFARI,2006,2,0,0.0,2,100.0,0,0.0
TATA,SAFARI,2008,3,0,0.0,3,100.0,0,0.0
TESLA,ELECTRIC CAR,2010,1,0,0.0,1,100.0,0,0.0
TESLA,MODEL S,2014,14,7,50.0,7,50.0,2,14.3
TESLA,MODEL S,2015,2,0,0.0,2,100.0,0,0.0
TESLA,OTHER,2014,4,2,50.0,2,50.0,0,0.0
TESLA,OTHER,2015,1,1,100.0,0,0.0,0,0.0
TIGER,OTHER,2003,1,0,0.0,1,100.0,0,0.0
TIGER,OTHER,2008,1,1,100.0,0,0.0,0,0.0
TOYOTA,ALLEX,2005,2,2,100.0,0,0.0,0,0.0
TOYOTA,ALLEX,2006,5,4,80.0,1,20.0,0,0.0
TOYOTA,ALLEX 1.5 NZE VVTI 5DR A,2004,1,0,0.0,1,100.0,0,0.0
TOYOTA,ALPHARD,2003,1,1,100.0,0,0.0,0,0.0
TOYOTA,ALPHARD,2004,1,1,100.0,0,0.0,0,0.0
TOYOTA,ALPHARD,2007,3,1,33.3,2,66.7,0,0.0
TOYOTA,ALPHARD,2008,3,3,100.0,0,0.0,0,0.0
TOYOTA,ALPHARD,2011,1,1,100.0,0,0.0,0,0.0
TOYOTA,ALPHARD,2012,1,1,100.0,0,0.0,0,0.0
TOYOTA,ALTEZZA,1999,14,8,57.1,6,42.9,0,0.0
TOYOTA,ALTEZZA,2000,7,3,42.9,4,57.1,0,0.0
TOYOTA,ALTEZZA,2001,11,5,45.5,6,54.5,0,0.0
TOYOTA,ALTEZZA,2002,3,1,33.3,2,66.7,0,0.0
TOYOTA,ALTEZZA,2003,2,2,100.0,0,0.0,0,0.0
TOYOTA,ALTEZZA,2004,2,1,50.0,1,50.0,0,0.0
TOYOTA,ALTEZZA SXE10,1999,1,0,0.0,1,100.0,0,0.0
TOYOTA,AQUA,2012,12,9,75.0,3,25.0,0,0.0
TOYOTA,AQUA,2013,52,43,82.7,9,17.3,1,1.9
TOYOTA,AQUA,2014,1,1,100.0,0,0.0,0,0.0
TOYOTA,ARISTO,1995,1,1,100.0,0,0.0,0,0.0
TOYOTA,ARISTO,1999,2,1,50.0,1,50.0,0,0.0
TOYOTA,ARISTO,2002,3,1,33.3,2,66.7,0,0.0
TOYOTA,AURION,2010,1,1,100.0,0,0.0,0,0.0
TOYOTA,AURIS,2006,2,1,50.0,1,50.0,0,0.0
TOYOTA,AURIS,2007,4155,2346,56.5,1809,43.5,3,0.1
TOYOTA,AURIS,2008,2791,1420,50.9,1371,49.1,0,0.0
TOYOTA,AURIS,2009,1544,832,53.9,712,46.1,0,0.0
TOYOTA,AURIS,2010,2212,1377,62.3,835,37.7,2,0.1
TOYOTA,AURIS,2011,555,376,67.7,179,32.3,2,0.4
TOYOTA,AURIS,2012,1776,1334,75.1,442,24.9,6,0.3
TOYOTA,AURIS,2013,473,406,85.8,67,14.2,1,0.2
TOYOTA,AURIS,2014,2449,2158,88.1,291,11.9,10,0.4
TOYOTA,AURIS,2015,367,328,89.4,39,10.6,2,0.5
TOYOTA,AURIS,2016,10,9,90.0,1,10.0,0,0.0
TOYOTA,AURIS,2017,2,2,100.0,0,0.0,0,0.0
TOYOTA,AURIS,2018,1,1,100.0,0,0.0,0,0.0
TOYOTA,AURIS TR D4D 3DR,2010,1,1,100.0,0,0.0,0,0.0
TOYOTA,AVENSIS,1997,7,3,42.9,4,57.1,0,0.0
TOYOTA,AVENSIS,1998,353,105,29.7,248,70.3,0,0.0
TOYOTA,AVENSIS,1999,658,213,32.4,445,67.6,0,0.0
TOYOTA,AVENSIS,2000,1004,305,30.4,699,69.6,0,0.0
TOYOTA,AVENSIS,2001,1067,331,31.0,736,69.0,0,0.0
TOYOTA,AVENSIS,2002,1444,497,34.4,947,65.6,0,0.0
TOYOTA,AVENSIS,2003,2668,843,31.6,1825,68.4,0,0.0
TOYOTA,AVENSIS,2004,4704,1504,32.0,3200,68.0,1,0.0
TOYOTA,AVENSIS,2005,7283,2596,35.6,4687,64.4,3,0.0
TOYOTA,AVENSIS,2006,7322,2693,36.8,4629,63.2,2,0.0
TOYOTA,AVENSIS,2007,7406,2826,38.2,4580,61.8,1,0.0
TOYOTA,AVENSIS,2008,3637,1366,37.6,2271,62.4,1,0.0
TOYOTA,AVENSIS,2009,1913,901,47.1,1012,52.9,1,0.1
TOYOTA,AVENSIS,2010,3196,1960,61.3,1236,38.7,2,0.1
TOYOTA,AVENSIS,2011,938,586,62.5,352,37.5,0,0.0
TOYOTA,AVENSIS,2012,2278,1697,74.5,581,25.5,1,0.0
TOYOTA,AVENSIS,2013,458,348,76.0,110,24.0,0,0.0
TOYOTA,AVENSIS,2014,1271,1019,80.2,252,19.8,1,0.1
TOYOTA,AVENSIS,2015,370,318,85.9,52,14.1,0,0.0
TOYOTA,AVENSIS,2016,115,98,85.2,17,14.8,0,0.0
TOYOTA,AVENSIS,2017,71,59,83.1,12,16.9,0,0.0
TOYOTA,AVENSIS,2018,10,9,90.0,1,10.0,0,0.0
TOYOTA,AVENSIS 2.0 TD GS 5DR,1998,1,1,100.0,0,0.0,0,0.0
TOYOTA,AVENSIS D4D 2.0 OVERMOUNT,2004,1,0,0.0,1,100.0,0,0.0
TOYOTA,AVENSIS D4D 2.0 OVERMOUNT,2006,1,0,0.0,1,100.0,0,0.0
TOYOTA,AVENSIS D4D 2.0 OVERMOUNT,2008,4,1,25.0,3,75.0,0,0.0
TOYOTA,AVENSIS D4D 2.0 OVERMOUNT,2009,719,354,49.2,365,50.8,0,0.0
TOYOTA,AVENSIS D4D 2.0 OVERMOUNT,2010,1398,791,56.6,607,43.4,3,0.2
TOYOTA,AVENSIS D4D 2.0 OVERMOUNT,2011,395,224,56.7,171,43.3,0,0.0
TOYOTA,AVENSIS D4D 2.0 OVERMOUNT,2012,1242,894,72.0,348,28.0,2,0.2
TOYOTA,AVENSIS D4D 2.0 OVERMOUNT,2013,272,201,73.9,71,26.1,0,0.0
TOYOTA,AVENSIS D4D 2.0 OVERMOUNT,2014,748,611,81.7,137,18.3,0,0.0
TOYOTA,AVENSIS D4D 2.0 OVERMOUNT,2015,91,73,80.2,18,19.8,0,0.0
TOYOTA,AVENSIS D4D 2.0 OVERMOUNT,2016,16,13,81.3,3,18.8,0,0.0
TOYOTA,AVENSIS D4D 2.0 OVERMOUNT,2017,9,9,100.0,0,0.0,0,0.0
TOYOTA,AVENSIS T2 4DR,2010,1,0,0.0,1,100.0,0,0.0
TOYOTA,AYGO,2005,67,31,46.3,36,53.7,0,0.0
TOYOTA,AYGO,2006,703,376,53.5,327,46.5,0,0.0
TOYOTA,AYGO,2007,464,268,57.8,196,42.2,0,0.0
TOYOTA,AYGO,2008,226,116,51.3,110,48.7,0,0.0
TOYOTA,AYGO,2009,69,37,53.6,32,46.4,0,0.0
TOYOTA,AYGO,2010,238,167,70.2,71,29.8,0,0.0
TOYOTA,AYGO,2011,59,41,69.5,18,30.5,0,0.0
TOYOTA,AYGO,2012,138,110,79.7,28,20.3,0,0.0
TOYOTA,AYGO,2013,36,27,75.0,9,25.0,0,0.0
TOYOTA,AYGO,2014,172,136,79.1,36,20.9,0,0.0
TOYOTA,AYGO,2015,48,37,77.1,11,22.9,0,0.0
TOYOTA,BB,2002,1,1,100.0,0,0.0,0,0.0
TOYOTA,BB,2006,1,0,0.0,1,100.0,0,0.0
TOYOTA,BB,2007,6,4,66.7,2,33.3,0,0.0
TOYOTA,BB,2008,2,1,50.0,1,50.0,0,0.0
TOYOTA,BB,2009,1,1,100.0,0,0.0,0,0.0
TOYOTA,BB,2011,1,0,0.0,1,100.0,0,0.0
TOYOTA,BELTA,2008,2,0,0.0,2,100.0,0,0.0
TOYOTA,CALDINA,2002,1,0,0.0,1,100.0,0,0.0
TOYOTA,CALDINA,2004,1,0,0.0,1,100.0,0,0.0
TOYOTA,CAMRY,1986,1,0,0.0,1,100.0,0,0.0
TOYOTA,CAMRY,1987,4,2,50.0,2,50.0,0,0.0
TOYOTA,CAMRY,1988,2,1,50.0,1,50.0,0,0.0
TOYOTA,CAMRY,1991,1,1,100.0,0,0.0,0,0.0
TOYOTA,CAMRY,1992,2,2,100.0,0,0.0,0,0.0
TOYOTA,CAMRY,1993,2,1,50.0,1,50.0,0,0.0
TOYOTA,CAMRY,1994,2,2,100.0,0,0.0,0,0.0
TOYOTA,CAMRY,1995,5,2,40.0,3,60.0,0,0.0
TOYOTA,CAMRY,1996,8,2,25.0,6,75.0,0,0.0
TOYOTA,CAMRY,1997,8,3,37.5,5,62.5,0,0.0
TOYOTA,CAMRY,1998,14,9,64.3,5,35.7,0,0.0
TOYOTA,CAMRY,1999,10,5,50.0,5,50.0,0,0.0
TOYOTA,CAMRY,2000,18,10,55.6,8,44.4,0,0.0
TOYOTA,CAMRY,2001,16,8,50.0,8,50.0,1,6.3
TOYOTA,CAMRY,2002,51,32,62.7,19,37.3,0,0.0
TOYOTA,CAMRY,2003,70,40,57.1,30,42.9,0,0.0
TOYOTA,CAMRY,2004,123,67,54.5,56,45.5,0,0.0
TOYOTA,CAMRY,2005,13,6,46.2,7,53.8,0,0.0
TOYOTA,CAMRY,2006,2,0,0.0,2,100.0,0,0.0
TOYOTA,CAMRY,2007,1,0,0.0,1,100.0,0,0.0
TOYOTA,CAMRY,2008,3,2,66.7,1,33.3,0,0.0
TOYOTA,CAMRY,2012,23,16,69.6,7,30.4,1,4.3
TOYOTA,CAMRY,2013,32,21,65.6,11,34.4,1,3.1
TOYOTA,CAMRY,2014,2,0,0.0,2,100.0,0,0.0
TOYOTA,CARINA,1981,1,0,0.0,1,100.0,0,0.0
TOYOTA,CARINA,1984,4,3,75.0,1,25.0,0,0.0
TOYOTA,CARINA,1985,1,0,0.0,1,100.0,0,0.0
TOYOTA,CARINA,1987,5,2,40.0,3,60.0,0,0.0
TOYOTA,CARINA,1988,11,4,36.4,7,63.6,0,0.0
TOYOTA,CARINA,1989,15,5,33.3,10,66.7,0,0.0
TOYOTA,CARINA,1990,37,12,32.4,25,67.6,0,0.0
TOYOTA,CARINA,1991,31,12,38.7,19,61.3,0,0.0
TOYOTA,CARINA,1992,50,18,36.0,32,64.0,0,0.0
TOYOTA,CARINA,1993,75,28,37.3,47,62.7,0,0.0
TOYOTA,CARINA,1994,80,26,32.5,54,67.5,0,0.0
TOYOTA,CARINA,1995,89,28,31.5,61,68.5,0,0.0
TOYOTA,CARINA,1996,126,51,40.5,75,59.5,0,0.0
TOYOTA,CARINA,1997,185,81,43.8,104,56.2,0,0.0
TOYOTA,CARINA,1998,8,1,12.5,7,87.5,0,0.0
TOYOTA,CARINA,1999,1,1,100.0,0,0.0,0,0.0
TOYOTA,CELICA,1981,2,1,50.0,1,50.0,0,0.0
TOYOTA,CELICA,1983,1,1,100.0,0,0.0,0,0.0
TOYOTA,CELICA,1984,5,3,60.0,2,40.0,0,0.0
TOYOTA,CELICA,1985,2,0,0.0,2,100.0,0,0.0
TOYOTA,CELICA,1986,1,1,100.0,0,0.0,0,0.0
TOYOTA,CELICA,1987,6,2,33.3,4,66.7,0,0.0
TOYOTA,CELICA,1988,5,3,60.0,2,40.0,0,0.0
TOYOTA,CELICA,1989,1,1,100.0,0,0.0,0,0.0
TOYOTA,CELICA,1990,16,2,12.5,14,87.5,0,0.0
TOYOTA,CELICA,1991,13,6,46.2,7,53.8,0,0.0
TOYOTA,CELICA,1992,13,5,38.5,8,61.5,0,0.0
TOYOTA,CELICA,1993,10,3,30.0,7,70.0,0,0.0
TOYOTA,CELICA,1994,30,14,46.7,16,53.3,0,0.0
TOYOTA,CELICA,1995,34,8,23.5,26,76.5,0,0.0
TOYOTA,CELICA,1996,39,14,35.9,25,64.1,0,0.0
TOYOTA,CELICA,1997,16,4,25.0,12,75.0,0,0.0
TOYOTA,CELICA,1998,44,17,38.6,27,61.4,0,0.0
TOYOTA,CELICA,1999,62,27,43.5,35,56.5,0,0.0
TOYOTA,CELICA,2000,141,54,38.3,87,61.7,1,0.7
TOYOTA,CELICA,2001,97,42,43.3,55,56.7,0,0.0
TOYOTA,CELICA,2002,107,42,39.3,65,60.7,0,0.0
TOYOTA,CELICA,2003,80,35,43.8,45,56.3,0,0.0
TOYOTA,CELICA,2004,133,54,40.6,79,59.4,0,0.0
TOYOTA,CELICA,2005,87,45,51.7,42,48.3,0,0.0
TOYOTA,CELICA,2006,22,14,63.6,8,36.4,0,0.0
TOYOTA,CELICA,2007,1,0,0.0,1,100.0,0,0.0
TOYOTA,CELICA GT VVTI 16V LHD 3DR,2000,1,0,0.0,1,100.0,0,0.0
TOYOTA,CHASER,1996,2,0,0.0,2,100.0,0,0.0
TOYOTA,CHASER,1997,8,0,0.0,8,100.0,0,0.0
TOYOTA,CHASER,1998,15,3,20.0,12,80.0,0,0.0
TOYOTA,CHASER,1999,9,3,33.3,6,66.7,0,0.0
TOYOTA,CHASER,2000,1,0,0.0,1,100.0,0,0.0
TOYOTA,CHASER,2001,4,1,25.0,3,75.0,0,0.0
TOYOTA,CHASER,2011,1,1,100.0,0,0.0,0,0.0
TOYOTA,COROLLA,1981,1,0,0.0,1,100.0,0,0.0
TOYOTA,COROLLA,1982,1,0,0.0,1,100.0,0,0.0
TOYOTA,COROLLA,1983,6,0,0.0,6,100.0,0,0.0
TOYOTA,COROLLA,1984,30,9,30.0,21,70.0,0,0.0
TOYOTA,COROLLA,1985,46,17,37.0,29,63.0,0,0.0
TOYOTA,COROLLA,1986,82,30,36.6,52,63.4,0,0.0
TOYOTA,COROLLA,1987,35,19,54.3,16,45.7,0,0.0
TOYOTA,COROLLA,1988,19,12,63.2,7,36.8,0,0.0
TOYOTA,COROLLA,1989,18,6,33.3,12,66.7,0,0.0
TOYOTA,COROLLA,1990,45,17,37.8,28,62.2,0,0.0
TOYOTA,COROLLA,1991,54,35,64.8,19,35.2,0,0.0
TOYOTA,COROLLA,1992,105,42,40.0,63,60.0,0,0.0
TOYOTA,COROLLA,1993,179,91,50.8,88,49.2,0,0.0
TOYOTA,COROLLA,1994,277,121,43.7,156,56.3,0,0.0
TOYOTA,COROLLA,1995,356,151,42.4,205,57.6,0,0.0
TOYOTA,COROLLA,1996,495,193,39.0,302,61.0,0,0.0
TOYOTA,COROLLA,1997,884,361,40.8,523,59.2,0,0.0
TOYOTA,COROLLA,1998,1572,553,35.2,1019,64.8,0,0.0
TOYOTA,COROLLA,1999,1977,738,37.3,1239,62.7,0,0.0
TOYOTA,COROLLA,2000,2960,1121,37.9,1839,62.1,2,0.1
TOYOTA,COROLLA,2001,2565,1018,39.7,1547,60.3,2,0.1
TOYOTA,COROLLA,2002,4445,1709,38.4,2736,61.6,0,0.0
TOYOTA,COROLLA,2003,6028,2433,40.4,3595,59.6,3,0.0
TOYOTA,COROLLA,2004,7374,3129,42.4,4245,57.6,3,0.0
TOYOTA,COROLLA,2005,10556,4966,47.0,5590,53.0,4,0.0
TOYOTA,COROLLA,2006,10216,5474,53.6,4742,46.4,7,0.1
TOYOTA,COROLLA,2007,7204,4168,57.9,3036,42.1,0,0.0
TOYOTA,COROLLA,2008,3224,1981,61.4,1243,38.6,1,0.0
TOYOTA,COROLLA,2009,843,485,57.5,358,42.5,0,0.0
TOYOTA,COROLLA,2010,1677,1128,67.3,549,32.7,1,0.1
TOYOTA,COROLLA,2011,448,252,56.3,196,43.8,0,0.0
TOYOTA,COROLLA,2012,1329,993,74.7,336,25.3,0,0.0
TOYOTA,COROLLA,2013,194,145,74.7,49,25.3,0,0.0
TOYOTA,COROLLA,2014,2435,2078,85.3,357,14.7,2,0.1
TOYOTA,COROLLA,2015,545,476,87.3,69,12.7,1,0.2
TOYOTA,COROLLA,2016,76,63,82.9,13,17.1,0,0.0
TOYOTA,COROLLA,2017,33,30,90.9,3,9.1,0,0.0
TOYOTA,COROLLA,2018,9,8,88.9,1,11.1,0,0.0
TOYOTA,COROLLA 1.4 D4D T3 5DR,2004,1,0,0.0,1,100.0,0,0.0
TOYOTA,COROLLA 1.4 VVTI COLOUR 5DR,2007,1,1,100.0,0,0.0,0,0.0
TOYOTA,COROLLA 1.4 VVTI T2 5DR,2003,1,0,0.0,1,100.0,0,0.0
TOYOTA,COROLLA 1.4 VVTI T2 5DR,2004,2,1,50.0,1,50.0,0,0.0
TOYOTA,COROLLA 1.6 VVTI T3 3DR,1984,1,0,0.0,1,100.0,0,0.0
TOYOTA,COROLLA 1.6 VVTI T3 3DR,1985,1,0,0.0,1,100.0,0,0.0
TOYOTA,COROLLA 1.6 VVTI T3 3DR,1989,1,1,100.0,0,0.0,0,0.0
TOYOTA,COROLLA 1.6 VVTI T3 3DR,1992,2,1,50.0,1,50.0,0,0.0
TOYOTA,COROLLA 1.6 VVTI T3 3DR,2014,1,0,0.0,1,100.0,0,0.0
TOYOTA,COROLLA LEVIN,1984,2,2,100.0,0,0.0,0,0.0
TOYOTA,COROLLA LUNA 4DR,2008,1,1,100.0,0,0.0,0,0.0
TOYOTA,COROLLA VERSO 1HD,2005,1,1,100.0,0,0.0,0,0.0
TOYOTA,CORONA,1983,1,0,0.0,1,100.0,0,0.0
TOYOTA,CORONA,1988,1,0,0.0,1,100.0,0,0.0
TOYOTA,CORONA,1993,1,0,0.0,1,100.0,0,0.0
TOYOTA,CORONA,1994,1,1,100.0,0,0.0,0,0.0
TOYOTA,CORONA,1995,1,0,0.0,1,100.0,0,0.0
TOYOTA,CORONA,1997,3,2,66.7,1,33.3,0,0.0
TOYOTA,CORONA,2007,1,1,100.0,0,0.0,0,0.0
TOYOTA,CRESSIDA,1982,1,1,100.0,0,0.0,0,0.0
TOYOTA,CRESTA,1998,2,1,50.0,1,50.0,0,0.0
TOYOTA,CROWN,1991,1,1,100.0,0,0.0,0,0.0
TOYOTA,CROWN,1994,1,0,0.0,1,100.0,0,0.0
TOYOTA,CROWN,2000,1,1,100.0,0,0.0,0,0.0
TOYOTA,CROWN,2003,1,0,0.0,1,100.0,0,0.0
TOYOTA,CROWN,2005,1,1,100.0,0,0.0,0,0.0
TOYOTA,CROWN,2013,2,1,50.0,1,50.0,0,0.0
TOYOTA,CYNOS,1996,4,1,25.0,3,75.0,0,0.0
TOYOTA,CYNOS,1997,3,0,0.0,3,100.0,0,0.0
TOYOTA,CYNOS,1998,5,3,60.0,2,40.0,0,0.0
TOYOTA,CYNOS,1999,3,2,66.7,1,33.3,0,0.0
TOYOTA,DUET,2003,4,3,75.0,1,25.0,0,0.0
TOYOTA,DYNA,1988,1,0,0.0,1,100.0,0,0.0
TOYOTA,ESTIMA,1992,1,0,0.0,1,100.0,0,0.0
TOYOTA,ESTIMA,1997,2,0,0.0,2,100.0,0,0.0
TOYOTA,ESTIMA,2001,1,1,100.0,0,0.0,0,0.0
TOYOTA,ESTIMA,2002,1,1,100.0,0,0.0,0,0.0
TOYOTA,ESTIMA,2003,2,0,0.0,2,100.0,0,0.0
TOYOTA,ESTIMA,2004,5,4,80.0,1,20.0,0,0.0
TOYOTA,ESTIMA,2005,4,1,25.0,3,75.0,0,0.0
TOYOTA,ESTIMA,2006,3,2,66.7,1,33.3,0,0.0
TOYOTA,ESTIMA,2008,19,10,52.6,9,47.4,2,10.5
TOYOTA,ESTIMA,2009,18,14,77.8,4,22.2,0,0.0
TOYOTA,ESTIMA,2010,10,7,70.0,3,30.0,0,0.0
TOYOTA,ESTIMA,2011,6,3,50.0,3,50.0,0,0.0
TOYOTA,ESTIMA,2012,11,10,90.9,1,9.1,0,0.0
TOYOTA,ESTIMA,2013,5,4,80.0,1,20.0,0,0.0
TOYOTA,FORTUNER,2005,1,1,100.0,0,0.0,0,0.0
TOYOTA,FORTUNER,2006,1,1,100.0,0,0.0,0,0.0
TOYOTA,FORTUNER,2007,1,0,0.0,1,100.0,0,0.0
TOYOTA,FORTUNER,2008,2,1,50.0,1,50.0,0,0.0
TOYOTA,FORTUNER,2009,1,1,100.0,0,0.0,0,0.0
TOYOTA,FORTUNER,2013,1,1,100.0,0,0.0,0,0.0
TOYOTA,FUNCARGO,2001,1,1,100.0,0,0.0,0,0.0
TOYOTA,FUNCARGO,2002,3,2,66.7,1,33.3,0,0.0
TOYOTA,FUNCARGO,2003,3,3,100.0,0,0.0,0,0.0
TOYOTA,FUNCARGO,2004,4,3,75.0,1,25.0,0,0.0
TOYOTA,FUNCARGO,2005,3,0,0.0,3,100.0,0,0.0
TOYOTA,GT86,1986,1,1,100.0,0,0.0,0,0.0
TOYOTA,GT86,2012,25,18,72.0,7,28.0,0,0.0
TOYOTA,GT86,2013,12,12,100.0,0,0.0,0,0.0
TOYOTA,GT86,2014,9,8,88.9,1,11.1,0,0.0
TOYOTA,HARRIER,2005,1,1,100.0,0,0.0,0,0.0
TOYOTA,HARRIER,2014,1,1,100.0,0,0.0,0,0.0
TOYOTA,HIACE,1992,1,0,0.0,1,100.0,0,0.0
TOYOTA,HIACE,1994,1,1,100.0,0,0.0,0,0.0
TOYOTA,HIACE,1998,6,1,16.7,5,83.3,0,0.0
TOYOTA,HIACE,1999,15,1,6.7,14,93.3,1,6.7
TOYOTA,HIACE,2000,6,1,16.7,5,83.3,0,0.0
TOYOTA,HIACE,2001,7,3,42.9,4,57.1,0,0.0
TOYOTA,HIACE,2002,4,2,50.0,2,50.0,0,0.0
TOYOTA,HIACE,2003,3,1,33.3,2,66.7,0,0.0
TOYOTA,HIACE,2005,9,5,55.6,4,44.4,0,0.0
TOYOTA,HIACE,2006,4,1,25.0,3,75.0,0,0.0
TOYOTA,HIACE,2007,6,1,16.7,5,83.3,0,0.0
TOYOTA,HIACE,2008,8,2,25.0,6,75.0,0,0.0
TOYOTA,HIACE,2009,1,1,100.0,0,0.0,0,0.0
TOYOTA,HIACE,2010,1,0,0.0,1,100.0,0,0.0
TOYOTA,HIACE,2011,6,3,50.0,3,50.0,0,0.0
TOYOTA,HIACE,2012,11,6,54.5,5,45.5,0,0.0
TOYOTA,HIGHLANDER,2006,1,0,0.0,1,100.0,0,0.0
TOYOTA,HIGHLANDER,2008,1,0,0.0,1,100.0,0,0.0
TOYOTA,HILUX,1988,1,1,100.0,0,0.0,0,0.0
TOYOTA,HILUX,1992,1,0,0.0,1,100.0,1,100.0
TOYOTA,HILUX,1993,1,1,100.0,0,0.0,0,0.0
TOYOTA,HILUX,1999,1,0,0.0,1,100.0,0,0.0
TOYOTA,HILUX,2007,1,1,100.0,0,0.0,0,0.0
TOYOTA,HILUX,2010,1,1,100.0,0,0.0,0,0.0
TOYOTA,IQ,2009,37,33,89.2,4,10.8,0,0.0
TOYOTA,IQ,2010,40,34,85.0,6,15.0,0,0.0
TOYOTA,IQ,2011,10,7,70.0,3,30.0,0,0.0
TOYOTA,IQ,2012,8,6,75.0,2,25.0,0,0.0
TOYOTA,IQ,2013,3,2,66.7,1,33.3,0,0.0
TOYOTA,IQ,2014,11,10,90.9,1,9.1,0,0.0
TOYOTA,ISIS,2005,2,1,50.0,1,50.0,0,0.0
TOYOTA,ISIS,2006,5,5,100.0,0,0.0,0,0.0
TOYOTA,ISIS,2007,2,2,100.0,0,0.0,0,0.0
TOYOTA,IST,2003,1,0,0.0,1,100.0,0,0.0
TOYOTA,IST,2004,1,1,100.0,0,0.0,0,0.0
TOYOTA,IST,2010,1,1,100.0,0,0.0,0,0.0
TOYOTA,LANDCRUISER,1981,1,0,0.0,1,100.0,0,0.0
TOYOTA,LANDCRUISER,1984,1,0,0.0,1,100.0,0,0.0
TOYOTA,LANDCRUISER,1988,1,0,0.0,1,100.0,0,0.0
TOYOTA,LANDCRUISER,1990,1,0,0.0,1,100.0,0,0.0
TOYOTA,LANDCRUISER,1991,1,1,100.0,0,0.0,0,0.0
TOYOTA,LANDCRUISER,1992,1,1,100.0,0,0.0,0,0.0
TOYOTA,LANDCRUISER,1993,2,0,0.0,2,100.0,0,0.0
TOYOTA,LANDCRUISER,1994,1,0,0.0,1,100.0,0,0.0
TOYOTA,LANDCRUISER,1996,4,2,50.0,2,50.0,0,0.0
TOYOTA,LANDCRUISER,1997,18,9,50.0,9,50.0,0,0.0
TOYOTA,LANDCRUISER,1998,14,1,7.1,13,92.9,0,0.0
TOYOTA,LANDCRUISER,1999,17,6,35.3,11,64.7,0,0.0
TOYOTA,LANDCRUISER,2000,14,6,42.9,8,57.1,0,0.0
TOYOTA,LANDCRUISER,2001,23,10,43.5,13,56.5,0,0.0
TOYOTA,LANDCRUISER,2002,23,9,39.1,14,60.9,0,0.0
TOYOTA,LANDCRUISER,2003,51,24,47.1,27,52.9,0,0.0
TOYOTA,LANDCRUISER,2004,115,50,43.5,65,56.5,0,0.0
TOYOTA,LANDCRUISER,2005,155,64,41.3,91,58.7,0,0.0
TOYOTA,LANDCRUISER,2006,162,71,43.8,91,56.2,0,0.0
TOYOTA,LANDCRUISER,2007,143,68,47.6,75,52.4,0,0.0
TOYOTA,LANDCRUISER,2008,76,47,61.8,29,38.2,0,0.0
TOYOTA,LANDCRUISER,2010,23,15,65.2,8,34.8,1,4.3
TOYOTA,LANDCRUISER,2011,2,1,50.0,1,50.0,0,0.0
TOYOTA,LANDCRUISER,2012,12,9,75.0,3,25.0,0,0.0
TOYOTA,LANDCRUISER,2013,2,2,100.0,0,0.0,0,0.0
TOYOTA,LANDCRUISER,2014,9,6,66.7,3,33.3,1,11.1
TOYOTA,LANDCRUISER 3.0 D4D LC4 5DR,2004,1,1,100.0,0,0.0,0,0.0
TOYOTA,LANDCRUISER PRADO VX AUTO,2007,1,1,100.0,0,0.0,0,0.0
TOYOTA,LEVIN,1983,3,0,0.0,3,100.0,0,0.0
TOYOTA,LEVIN,1984,5,1,20.0,4,80.0,0,0.0
TOYOTA,LEVIN,1985,5,1,20.0,4,80.0,0,0.0
TOYOTA,LEVIN,1986,1,0,0.0,1,100.0,0,0.0
TOYOTA,LEVIN,1987,1,1,100.0,0,0.0,0,0.0
TOYOTA,LEVIN,1998,1,0,0.0,1,100.0,0,0.0
TOYOTA,LITEACE,1991,1,0,0.0,1,100.0,0,0.0
TOYOTA,LITEACE,1998,1,0,0.0,1,100.0,0,0.0
TOYOTA,MARK 11,2001,1,0,0.0,1,100.0,0,0.0
TOYOTA,MARK 11,2004,1,0,0.0,1,100.0,0,0.0
TOYOTA,MARK-X,2005,1,1,100.0,0,0.0,0,0.0
TOYOTA,MARK-X,2012,1,0,0.0,1,100.0,0,0.0
TOYOTA,MR2,1987,1,0,0.0,1,100.0,0,0.0
TOYOTA,MR2,1988,2,1,50.0,1,50.0,0,0.0
TOYOTA,MR2,1992,1,1,100.0,0,0.0,0,0.0
TOYOTA,MR2,2001,2,1,50.0,1,50.0,0,0.0
TOYOTA,MR-S ZZW30 2DR A,2006,1,0,0.0,1,100.0,0,0.0
TOYOTA,NOAH,2004,6,3,50.0,3,50.0,0,0.0
TOYOTA,NOAH,2008,2,1,50.0,1,50.0,0,0.0
TOYOTA,OTHER,1980,1,1,100.0,0,0.0,0,0.0
TOYOTA,OTHER,1983,8,4,50.0,4,50.0,0,0.0
TOYOTA,OTHER,1984,19,2,10.5,17,89.5,0,0.0
TOYOTA,OTHER,1985,27,4,14.8,23,85.2,0,0.0
TOYOTA,OTHER,1986,35,10,28.6,25,71.4,0,0.0
TOYOTA,OTHER,1987,27,10,37.0,17,63.0,0,0.0
TOYOTA,OTHER,1988,13,3,23.1,10,76.9,0,0.0
TOYOTA,OTHER,1989,10,4,40.0,6,60.0,0,0.0
TOYOTA,OTHER,1990,18,7,38.9,11,61.1,0,0.0
TOYOTA,OTHER,1991,31,17,54.8,14,45.2,0,0.0
TOYOTA,OTHER,1992,42,15,35.7,27,64.3,0,0.0
TOYOTA,OTHER,1993,29,15,51.7,14,48.3,0,0.0
TOYOTA,OTHER,1994,55,15,27.3,40,72.7,0,0.0
TOYOTA,OTHER,1995,50,12,24.0,38,76.0,0,0.0
TOYOTA,OTHER,1996,58,20,34.5,38,65.5,0,0.0
TOYOTA,OTHER,1997,108,44,40.7,64,59.3,0,0.0
TOYOTA,OTHER,1998,165,44,26.7,121,73.3,1,0.6
TOYOTA,OTHER,1999,451,158,35.0,293,65.0,0,0.0
TOYOTA,OTHER,2000,423,157,37.1,266,62.9,0,0.0
TOYOTA,OTHER,2001,339,158,46.6,181,53.4,0,0.0
TOYOTA,OTHER,2002,200,75,37.5,125,62.5,1,0.5
TOYOTA,OTHER,2003,174,79,45.4,95,54.6,1,0.6
TOYOTA,OTHER,2004,224,126,56.3,98,43.8,0,0.0
TOYOTA,OTHER,2005,97,46,47.4,51,52.6,0,0.0
TOYOTA,OTHER,2006,90,54,60.0,36,40.0,0,0.0
TOYOTA,OTHER,2007,86,55,64.0,31,36.0,1,1.2
TOYOTA,OTHER,2008,23,11,47.8,12,52.2,0,0.0
TOYOTA,OTHER,2009,9,3,33.3,6,66.7,0,0.0
TOYOTA,OTHER,2010,35,29,82.9,6,17.1,0,0.0
TOYOTA,OTHER,2011,5,5,100.0,0,0.0,0,0.0
TOYOTA,OTHER,2012,4,3,75.0,1,25.0,0,0.0
TOYOTA,OTHER,2013,1,1,100.0,0,0.0,0,0.0
TOYOTA,OTHER,2014,1,1,100.0,0,0.0,0,0.0
TOYOTA,PASEO 1.5,1996,6,5,83.3,1,16.7,0,0.0
TOYOTA,PASEO 1.5,1997,3,1,33.3,2,66.7,0,0.0
TOYOTA,PASSO,2004,3,1,33.3,2,66.7,0,0.0
TOYOTA,PASSO,2005,7,3,42.9,4,57.1,0,0.0
TOYOTA,PASSO,2006,5,2,40.0,3,60.0,0,0.0
TOYOTA,PASSO,2007,15,3,20.0,12,80.0,0,0.0
TOYOTA,PASSO,2008,12,4,33.3,8,66.7,0,0.0
TOYOTA,PASSO,2009,12,2,16.7,10,83.3,0,0.0
TOYOTA,PASSO,2010,3,2,66.7,1,33.3,0,0.0
TOYOTA,PICNIC,1997,6,3,50.0,3,50.0,0,0.0
TOYOTA,PICNIC,1998,8,3,37.5,5,62.5,0,0.0
TOYOTA,PICNIC,1999,23,7,30.4,16,69.6,0,0.0
TOYOTA,PICNIC,2000,12,5,41.7,7,58.3,0,0.0
TOYOTA,PICNIC,2001,29,10,34.5,19,65.5,0,0.0
TOYOTA,PICNIC,2002,6,3,50.0,3,50.0,0,0.0
TOYOTA,PICNIC,2003,6,2,33.3,4,66.7,0,0.0
TOYOTA,PICNIC,2004,6,2,33.3,4,66.7,0,0.0
TOYOTA,PORTE,2004,1,1,100.0,0,0.0,0,0.0
TOYOTA,PREVIA,1995,2,1,50.0,1,50.0,0,0.0
TOYOTA,PREVIA,1996,2,1,50.0,1,50.0,0,0.0
TOYOTA,PREVIA,1997,4,0,0.0,4,100.0,0,0.0
TOYOTA,PREVIA,1998,4,1,25.0,3,75.0,0,0.0
TOYOTA,PREVIA,1999,2,1,50.0,1,50.0,0,0.0
TOYOTA,PREVIA,2000,1,0,0.0,1,100.0,0,0.0
TOYOTA,PREVIA,2001,19,4,21.1,15,78.9,0,0.0
TOYOTA,PREVIA,2002,25,8,32.0,17,68.0,0,0.0
TOYOTA,PREVIA,2003,24,10,41.7,14,58.3,0,0.0
TOYOTA,PREVIA,2004,55,19,34.5,36,65.5,0,0.0
TOYOTA,PREVIA,2005,53,20,37.7,33,62.3,0,0.0
TOYOTA,PREVIA,2006,38,9,23.7,29,76.3,0,0.0
TOYOTA,PRIUS,1998,1,1,100.0,0,0.0,0,0.0
TOYOTA,PRIUS,2000,7,2,28.6,5,71.4,0,0.0
TOYOTA,PRIUS,2001,9,7,77.8,2,22.2,0,0.0
TOYOTA,PRIUS,2002,11,6,54.5,5,45.5,0,0.0
TOYOTA,PRIUS,2003,11,3,27.3,8,72.7,0,0.0
TOYOTA,PRIUS,2004,206,103,50.0,103,50.0,3,1.5
TOYOTA,PRIUS,2005,306,169,55.2,137,44.8,3,1.0
TOYOTA,PRIUS,2006,360,190,52.8,170,47.2,10,2.8
TOYOTA,PRIUS,2007,548,350,63.9,198,36.1,4,0.7
TOYOTA,PRIUS,2008,522,352,67.4,170,32.6,8,1.5
TOYOTA,PRIUS,2009,183,109,59.6,74,40.4,3,1.6
TOYOTA,PRIUS,2010,702,467,66.5,235,33.5,11,1.6
TOYOTA,PRIUS,2011,380,240,63.2,140,36.8,7,1.8
TOYOTA,PRIUS,2012,554,362,65.3,192,34.7,16,2.9
TOYOTA,PRIUS,2013,759,523,68.9,236,31.1,12,1.6
TOYOTA,PRIUS,2014,405,289,71.4,116,28.6,6,1.5
TOYOTA,PRIUS,2015,162,137,84.6,25,15.4,2,1.2
TOYOTA,PRIUS,2016,36,33,91.7,3,8.3,0,0.0
TOYOTA,PRIUS,2017,23,19,82.6,4,17.4,1,4.3
TOYOTA,PRIUS,2018,7,5,71.4,2,28.6,0,0.0
TOYOTA,PROACE,2013,1,0,0.0,1,100.0,0,0.0
TOYOTA,PROACE,2014,1,0,0.0,1,100.0,0,0.0
TOYOTA,PROACE,2015,1,1,100.0,0,0.0,0,0.0
TOYOTA,PROACE,2017,5,2,40.0,3,60.0,0,0.0
TOYOTA,PROACE,2018,1,1,100.0,0,0.0,0,0.0
TOYOTA,RACTIS,2005,1,0,0.0,1,100.0,0,0.0
TOYOTA,RACTIS,2006,5,5,100.0,0,0.0,0,0.0
TOYOTA,RACTIS,2007,3,1,33.3,2,66.7,0,0.0
TOYOTA,RAV 4,1994,3,2,66.7,1,33.3,0,0.0
TOYOTA,RAV 4,1995,10,3,30.0,7,70.0,0,0.0
TOYOTA,RAV 4,1996,11,3,27.3,8,72.7,0,0.0
TOYOTA,RAV 4,1997,16,8,50.0,8,50.0,0,0.0
TOYOTA,RAV 4,1998,16,4,25.0,12,75.0,0,0.0
TOYOTA,RAV 4,1999,14,5,35.7,9,64.3,0,0.0
TOYOTA,RAV 4,2000,22,9,40.9,13,59.1,1,4.5
TOYOTA,RAV 4,2001,203,81,39.9,122,60.1,2,1.0
TOYOTA,RAV 4,2002,413,183,44.3,230,55.7,0,0.0
TOYOTA,RAV 4,2003,474,226,47.7,248,52.3,4,0.8
TOYOTA,RAV 4,2004,922,453,49.1,469,50.9,2,0.2
TOYOTA,RAV 4,2005,1146,582,50.8,564,49.2,0,0.0
TOYOTA,RAV 4,2006,853,488,57.2,365,42.8,3,0.4
TOYOTA,RAV 4,2007,1179,655,55.6,524,44.4,9,0.8
TOYOTA,RAV 4,2008,356,207,58.1,149,41.9,2,0.6
TOYOTA,RAV 4,2009,86,48,55.8,38,44.2,0,0.0
TOYOTA,RAV 4,2010,217,143,65.9,74,34.1,2,0.9
TOYOTA,RAV 4,2011,38,23,60.5,15,39.5,0,0.0
TOYOTA,RAV 4,2012,199,135,67.8,64,32.2,0,0.0
TOYOTA,RAV 4,2013,53,40,75.5,13,24.5,0,0.0
TOYOTA,RAV 4,2014,1240,1055,85.1,185,14.9,3,0.2
TOYOTA,RAV 4,2015,222,193,86.9,29,13.1,1,0.5
TOYOTA,RAV 4,2016,5,4,80.0,1,20.0,0,0.0
TOYOTA,RAV 4,2017,3,3,100.0,0,0.0,0,0.0
TOYOTA,RUSH,2009,1,1,100.0,0,0.0,0,0.0
TOYOTA,SAI,2010,2,0,0.0,2,100.0,0,0.0
TOYOTA,SIENNA LHD 5DR A,2004,2,0,0.0,2,100.0,0,0.0
TOYOTA,SIENTA,2003,1,0,0.0,1,100.0,0,0.0
TOYOTA,SIENTA,2004,12,4,33.3,8,66.7,0,0.0
TOYOTA,SIENTA,2005,5,3,60.0,2,40.0,0,0.0
TOYOTA,SIENTA,2006,10,5,50.0,5,50.0,0,0.0
TOYOTA,SIENTA,2007,1,0,0.0,1,100.0,0,0.0
TOYOTA,SIENTA,2008,2,2,100.0,0,0.0,0,0.0
TOYOTA,SIENTA,2009,2,1,50.0,1,50.0,0,0.0
TOYOTA,SIENTA,2010,1,1,100.0,0,0.0,0,0.0
TOYOTA,SIENTA,2011,1,0,0.0,1,100.0,0,0.0
TOYOTA,SIENTA,2012,1,0,0.0,1,100.0,0,0.0
TOYOTA,SOARER,1988,1,0,0.0,1,100.0,0,0.0
TOYOTA,SPRINTER,1983,1,1,100.0,0,0.0,0,0.0
TOYOTA,SPRINTER,1987,1,0,0.0,1,100.0,0,0.0
TOYOTA,SPRINTER,1988,1,1,100.0,0,0.0,0,0.0
TOYOTA,SPRINTER,1990,1,1,100.0,0,0.0,0,0.0
TOYOTA,SPRINTER,1991,2,0,0.0,2,100.0,0,0.0
TOYOTA,SPRINTER,1992,2,1,50.0,1,50.0,0,0.0
TOYOTA,STARLET,1979,1,1,100.0,0,0.0,0,0.0
TOYOTA,STARLET,1981,1,1,100.0,0,0.0,0,0.0
TOYOTA,STARLET,1982,2,0,0.0,2,100.0,0,0.0
TOYOTA,STARLET,1983,2,1,50.0,1,50.0,0,0.0
TOYOTA,STARLET,1984,11,7,63.6,4,36.4,0,0.0
TOYOTA,STARLET,1985,9,2,22.2,7,77.8,0,0.0
TOYOTA,STARLET,1986,11,4,36.4,7,63.6,0,0.0
TOYOTA,STARLET,1987,19,13,68.4,6,31.6,0,0.0
TOYOTA,STARLET,1988,51,24,47.1,27,52.9,0,0.0
TOYOTA,STARLET,1989,42,15,35.7,27,64.3,0,0.0
TOYOTA,STARLET,1990,73,35,47.9,38,52.1,0,0.0
TOYOTA,STARLET,1991,60,24,40.0,36,60.0,0,0.0
TOYOTA,STARLET,1992,81,32,39.5,49,60.5,0,0.0
TOYOTA,STARLET,1993,76,30,39.5,46,60.5,0,0.0
TOYOTA,STARLET,1994,98,37,37.8,61,62.2,0,0.0
TOYOTA,STARLET,1995,206,97,47.1,109,52.9,0,0.0
TOYOTA,STARLET,1996,393,194,49.4,199,50.6,0,0.0
TOYOTA,STARLET,1997,692,330,47.7,362,52.3,0,0.0
TOYOTA,STARLET,1998,916,370,40.4,546,59.6,1,0.1
TOYOTA,STARLET,1999,564,274,48.6,290,51.4,0,0.0
TOYOTA,STARLET,2000,3,1,33.3,2,66.7,0,0.0
TOYOTA,SUCCEED,2010,1,0,0.0,1,100.0,0,0.0
TOYOTA,SUPRA,1984,1,1,100.0,0,0.0,0,0.0
TOYOTA,SUPRA,1993,1,0,0.0,1,100.0,0,0.0
TOYOTA,TERCEL,1995,1,0,0.0,1,100.0,0,0.0
TOYOTA,TOWNACE,1991,1,1,100.0,0,0.0,0,0.0
TOYOTA,TOWNACE,2000,1,1,100.0,0,0.0,0,0.0
TOYOTA,TOYOTA PASSO KGC10 5DR A,2004,1,0,0.0,1,100.0,0,0.0
TOYOTA,TRUENO,1985,1,1,100.0,0,0.0,0,0.0
TOYOTA,TRUENO,1986,1,0,0.0,1,100.0,0,0.0
TOYOTA,URBAN CRUISER,2009,29,21,72.4,8,27.6,0,0.0
TOYOTA,URBAN CRUISER,2010,42,29,69.0,13,31.0,0,0.0
TOYOTA,URBAN CRUISER,2011,29,19,65.5,10,34.5,1,3.4
TOYOTA,URBAN CRUISER,2012,9,8,88.9,1,11.1,0,0.0
TOYOTA,URBAN CRUISER,2013,2,0,0.0,2,100.0,0,0.0
TOYOTA,URBAN CRUISER,2016,1,1,100.0,0,0.0,0,0.0
TOYOTA,VELLFIRE,2009,1,0,0.0,1,100.0,0,0.0
TOYOTA,VELLFIRE,2012,1,0,0.0,1,100.0,0,0.0
TOYOTA,VEROSSA,2003,1,1,100.0,0,0.0,0,0.0
TOYOTA,VEROSSA,2004,2,0,0.0,2,100.0,0,0.0
TOYOTA,VERSO,2005,2,0,0.0,2,100.0,0,0.0
TOYOTA,VERSO,2007,2,1,50.0,1,50.0,0,0.0
TOYOTA,VERSO,2008,4,1,25.0,3,75.0,0,0.0
TOYOTA,VERSO,2009,42,14,33.3,28,66.7,0,0.0
TOYOTA,VERSO,2010,387,220,56.8,167,43.2,0,0.0
TOYOTA,VERSO,2011,87,62,71.3,25,28.7,0,0.0
TOYOTA,VERSO,2012,290,193,66.6,97,33.4,0,0.0
TOYOTA,VERSO,2013,41,31,75.6,10,24.4,1,2.4
TOYOTA,VERSO,2014,259,209,80.7,50,19.3,1,0.4
TOYOTA,VERSO,2015,32,24,75.0,8,25.0,0,0.0
TOYOTA,VERSO,2016,6,6,100.0,0,0.0,0,0.0
TOYOTA,VERSO,2017,1,1,100.0,0,0.0,0,0.0
TOYOTA,VERSO,2018,1,1,100.0,0,0.0,0,0.0
TOYOTA,VERSO-S,2011,5,3,60.0,2,40.0,0,0.0
TOYOTA,VERSO-S,2012,107,89,83.2,18,16.8,0,0.0
TOYOTA,VERSO-S,2013,9,8,88.9,1,11.1,0,0.0
TOYOTA,VERSO-S,2014,72,62,86.1,10,13.9,0,0.0
TOYOTA,VERSO-S,2015,3,3,100.0,0,0.0,0,0.0
TOYOTA,VITZ,1999,3,2,66.7,1,33.3,0,0.0
TOYOTA,VITZ,2000,3,1,33.3,2,66.7,0,0.0
TOYOTA,VITZ,2001,3,1,33.3,2,66.7,0,0.0
TOYOTA,VITZ,2002,5,2,40.0,3,60.0,0,0.0
TOYOTA,VITZ,2003,9,7,77.8,2,22.2,0,0.0
TOYOTA,VITZ,2004,50,37,74.0,13,26.0,0,0.0
TOYOTA,VITZ,2005,104,56,53.8,48,46.2,0,0.0
TOYOTA,VITZ,2006,137,65,47.4,72,52.6,0,0.0
TOYOTA,VITZ,2007,222,116,52.3,106,47.7,0,0.0
TOYOTA,VITZ,2008,137,83,60.6,54,39.4,0,0.0
TOYOTA,VITZ,2009,227,136,59.9,91,40.1,0,0.0
TOYOTA,VITZ,2010,205,141,68.8,64,31.2,0,0.0
TOYOTA,VITZ,2011,23,15,65.2,8,34.8,0,0.0
TOYOTA,VITZ,2012,46,30,65.2,16,34.8,0,0.0
TOYOTA,VITZ,2013,34,18,52.9,16,47.1,0,0.0
TOYOTA,VITZ,2014,1,1,100.0,0,0.0,0,0.0
TOYOTA,VITZ SCP10 5DR,2004,1,1,100.0,0,0.0,0,0.0
TOYOTA,VITZ SCP13 5DR A,2004,2,2,100.0,0,0.0,0,0.0
TOYOTA,VOXY,2006,3,3,100.0,0,0.0,0,0.0
TOYOTA,VOXY,2007,5,3,60.0,2,40.0,0,0.0
TOYOTA,VOXY,2008,1,0,0.0,1,100.0,0,0.0
TOYOTA,VOXY,2009,1,0,0.0,1,100.0,0,0.0
TOYOTA,VOXY,2012,1,1,100.0,0,0.0,0,0.0
TOYOTA,VOXY,2015,2,1,50.0,1,50.0,0,0.0
TOYOTA,WISH,2004,2,2,100.0,0,0.0,0,0.0
TOYOTA,WISH,2006,10,7,70.0,3,30.0,0,0.0
TOYOTA,WISH,2007,10,3,30.0,7,70.0,0,0.0
TOYOTA,WISH,2008,4,2,50.0,2,50.0,0,0.0
TOYOTA,WISH,2009,4,2,50.0,2,50.0,0,0.0
TOYOTA,WISH,2010,3,1,33.3,2,66.7,0,0.0
TOYOTA,WISH,2011,1,1,100.0,0,0.0,0,0.0
TOYOTA,YARIS,1999,1682,708,42.1,974,57.9,0,0.0
TOYOTA,YARIS,2000,5103,2128,41.7,2975,58.3,2,0.0
TOYOTA,YARIS,2001,3609,1564,43.3,2045,56.7,1,0.0
TOYOTA,YARIS,2002,3579,1494,41.7,2085,58.3,3,0.1
TOYOTA,YARIS,2003,3565,1500,42.1,2065,57.9,1,0.0
TOYOTA,YARIS,2004,4206,1878,44.7,2328,55.3,1,0.0
TOYOTA,YARIS,2005,4149,2106,50.8,2043,49.2,4,0.1
TOYOTA,YARIS,2006,5526,3257,58.9,2269,41.1,5,0.1
TOYOTA,YARIS,2007,4745,2745,57.9,2000,42.1,0,0.0
TOYOTA,YARIS,2008,2105,1259,59.8,846,40.2,1,0.0
TOYOTA,YARIS,2009,1258,838,66.6,420,33.4,0,0.0
TOYOTA,YARIS,2010,2505,1960,78.2,545,21.8,0,0.0
TOYOTA,YARIS,2011,455,362,79.6,93,20.4,0,0.0
TOYOTA,YARIS,2012,1983,1585,79.9,398,20.1,1,0.1
TOYOTA,YARIS,2013,387,321,82.9,66,17.1,1,0.3
TOYOTA,YARIS,2014,1804,1554,86.1,250,13.9,9,0.5
TOYOTA,YARIS,2015,383,328,85.6,55,14.4,3,0.8
TOYOTA,YARIS,2016,1,0,0.0,1,100.0,0,0.0
TOYOTA,YARIS HYBRID,2012,14,11,78.6,3,21.4,0,0.0
TOYOTA,YARIS HYBRID,2013,17,9,52.9,8,47.1,0,0.0
TOYOTA,YARIS HYBRID,2014,110,87,79.1,23,20.9,2,1.8
TOYOTA,YARIS HYBRID,2015,10,10,100.0,0,0.0,0,0.0
TOYOTA,YARIS LUNA 1.0 LHD,2001,1,0,0.0,1,100.0,0,0.0
TOYOTA VELLFIRE,OTHER,2014,1,1,100.0,0,0.0,0,0.0
TRIUMPH,ACCLAIM,1982,1,1,100.0,0,0.0,0,0.0
TRIUMPH,OTHER,1952,1,1,100.0,0,0.0,0,0.0
TRIUMPH,OTHER,1955,1,1,100.0,0,0.0,0,0.0
TRIUMPH,TR7,1980,1,1,100.0,0,0.0,0,0.0
TRIUMPH,TR7,1981,2,0,0.0,2,100.0,0,0.0
TVR,4.0 CHIMAERA,1994,1,1,100.0,0,0.0,0,0.0
TVR,CHIMAERA,1996,1,0,0.0,1,100.0,0,0.0
TVR,CHIMAERA,1999,1,0,0.0,1,100.0,0,0.0
TVR,CHIMAERA 450,2000,1,1,100.0,0,0.0,0,0.0
TVR,TUSCAN,2001,1,1,100.0,0,0.0,0,0.0
VAUXHALL,ADAM,2013,3,1,33.3,2,66.7,0,0.0
VAUXHALL,ADAM,2014,9,6,66.7,3,33.3,0,0.0
VAUXHALL,ADAM,2015,2,2,100.0,0,0.0,0,0.0
VAUXHALL,AGILA,2002,3,1,33.3,2,66.7,0,0.0
VAUXHALL,AGILA,2003,4,3,75.0,1,25.0,0,0.0
VAUXHALL,AGILA,2004,6,3,50.0,3,50.0,0,0.0
VAUXHALL,AGILA,2005,11,2,18.2,9,81.8,0,0.0
VAUXHALL,AGILA,2006,15,7,46.7,8,53.3,0,0.0
VAUXHALL,AGILA,2007,6,4,66.7,2,33.3,0,0.0
VAUXHALL,AGILA,2008,9,3,33.3,6,66.7,0,0.0
VAUXHALL,AGILA,2009,8,3,37.5,5,62.5,0,0.0
VAUXHALL,AGILA,2010,10,7,70.0,3,30.0,0,0.0
VAUXHALL,AGILA,2011,5,4,80.0,1,20.0,0,0.0
VAUXHALL,AGILA,2012,15,8,53.3,7,46.7,0,0.0
VAUXHALL,AGILA,2013,6,5,83.3,1,16.7,0,0.0
VAUXHALL,AGILA,2014,13,10,76.9,3,23.1,0,0.0
VAUXHALL,AMPERA,2012,4,3,75.0,1,25.0,0,0.0
VAUXHALL,AMPERA,2013,1,1,100.0,0,0.0,0,0.0
VAUXHALL,AMPERA,2014,5,2,40.0,3,60.0,0,0.0
VAUXHALL,AMPERA,2015,1,1,100.0,0,0.0,0,0.0
VAUXHALL,ANTARA,2007,1,0,0.0,1,100.0,0,0.0
VAUXHALL,ANTARA,2008,1,1,100.0,0,0.0,0,0.0
VAUXHALL,ANTARA,2012,4,1,25.0,3,75.0,0,0.0
VAUXHALL,ANTARA,2013,3,1,33.3,2,66.7,0,0.0
VAUXHALL,ANTARA,2014,5,4,80.0,1,20.0,0,0.0
VAUXHALL,ASTRA,1984,1,0,0.0,1,100.0,0,0.0
VAUXHALL,ASTRA,1990,5,5,100.0,0,0.0,0,0.0
VAUXHALL,ASTRA,1992,3,0,0.0,3,100.0,0,0.0
VAUXHALL,ASTRA,1993,4,2,50.0,2,50.0,0,0.0
VAUXHALL,ASTRA,1994,5,2,40.0,3,60.0,0,0.0
VAUXHALL,ASTRA,1995,4,1,25.0,3,75.0,0,0.0
VAUXHALL,ASTRA,1996,1,1,100.0,0,0.0,0,0.0
VAUXHALL,ASTRA,1997,9,2,22.2,7,77.8,1,11.1
VAUXHALL,ASTRA,1998,11,4,36.4,7,63.6,0,0.0
VAUXHALL,ASTRA,1999,16,9,56.3,7,43.8,0,0.0
VAUXHALL,ASTRA,2000,31,9,29.0,22,71.0,0,0.0
VAUXHALL,ASTRA,2001,44,7,15.9,37,84.1,0,0.0
VAUXHALL,ASTRA,2002,88,28,31.8,60,68.2,0,0.0
VAUXHALL,ASTRA,2003,118,29,24.6,89,75.4,0,0.0
VAUXHALL,ASTRA,2004,232,66,28.4,166,71.6,0,0.0
VAUXHALL,ASTRA,2005,592,147,24.8,445,75.2,0,0.0
VAUXHALL,ASTRA,2006,694,190,27.4,504,72.6,0,0.0
VAUXHALL,ASTRA,2007,738,221,29.9,517,70.1,0,0.0
VAUXHALL,ASTRA,2008,1423,434,30.5,989,69.5,0,0.0
VAUXHALL,ASTRA,2009,687,239,34.8,448,65.2,0,0.0
VAUXHALL,ASTRA,2010,813,369,45.4,444,54.6,0,0.0
VAUXHALL,ASTRA,2011,394,237,60.2,157,39.8,0,0.0
VAUXHALL,ASTRA,2012,623,360,57.8,263,42.2,0,0.0
VAUXHALL,ASTRA,2013,288,200,69.4,88,30.6,0,0.0
VAUXHALL,ASTRA,2014,429,337,78.6,92,21.4,0,0.0
VAUXHALL,ASTRA,2015,22,21,95.5,1,4.5,0,0.0
VAUXHALL,ASTRA,2016,5,4,80.0,1,20.0,0,0.0
VAUXHALL,ASTRA 1.6 CLUB 8V 5DR,2004,1,0,0.0,1,100.0,0,0.0
VAUXHALL,ASTRA 1.7 CLUB CDTI 100BHP,2005,1,1,100.0,0,0.0,0,0.0
VAUXHALL,ASTRA 1.7 CLUB CDTI 100BHP,2009,1,0,0.0,1,100.0,0,0.0
VAUXHALL,ASTRA 1.7 CLUB CDTI 80HP 5DR,2009,1,0,0.0,1,100.0,0,0.0
VAUXHALL,CARLTON,1988,1,0,0.0,1,100.0,0,0.0
VAUXHALL,CARLTON,1993,2,2,100.0,0,0.0,0,0.0
VAUXHALL,CAVALIER,1981,1,1,100.0,0,0.0,0,0.0
VAUXHALL,CAVALIER,1986,2,0,0.0,2,100.0,0,0.0
VAUXHALL,CAVALIER,1988,1,0,0.0,1,100.0,0,0.0
VAUXHALL,CAVALIER,1991,1,0,0.0,1,100.0,0,0.0
VAUXHALL,CAVALIER,1992,2,1,50.0,1,50.0,0,0.0
VAUXHALL,CAVALIER,1993,6,2,33.3,4,66.7,0,0.0
VAUXHALL,CAVALIER,1994,3,1,33.3,2,66.7,0,0.0
VAUXHALL,CAVALIER,1995,6,0,0.0,6,100.0,0,0.0
VAUXHALL,CAVALIER,2008,3,0,0.0,3,100.0,0,0.0
VAUXHALL,CHEVETTE,1980,1,0,0.0,1,100.0,0,0.0
VAUXHALL,CHEVETTE,1983,2,1,50.0,1,50.0,0,0.0
VAUXHALL,COMBO,2005,2,2,100.0,0,0.0,0,0.0
VAUXHALL,COMBO,2006,1,0,0.0,1,100.0,0,0.0
VAUXHALL,COMBO,2009,4,2,50.0,2,50.0,0,0.0
VAUXHALL,COMBO,2010,8,6,75.0,2,25.0,0,0.0
VAUXHALL,COMBO,2011,1,0,0.0,1,100.0,0,0.0
VAUXHALL,COMBO,2012,4,3,75.0,1,25.0,0,0.0
VAUXHALL,COMBO,2018,1,1,100.0,0,0.0,0,0.0
VAUXHALL,CORSA,1998,1,1,100.0,0,0.0,0,0.0
VAUXHALL,CORSA,1999,3,0,0.0,3,100.0,0,0.0
VAUXHALL,CORSA,2000,2,0,0.0,2,100.0,0,0.0
VAUXHALL,CORSA,2001,6,3,50.0,3,50.0,0,0.0
VAUXHALL,CORSA,2002,24,6,25.0,18,75.0,0,0.0
VAUXHALL,CORSA,2003,44,10,22.7,34,77.3,0,0.0
VAUXHALL,CORSA,2004,99,22,22.2,77,77.8,0,0.0
VAUXHALL,CORSA,2005,127,38,29.9,89,70.1,0,0.0
VAUXHALL,CORSA,2006,146,42,28.8,104,71.2,0,0.0
VAUXHALL,CORSA,2007,244,97,39.8,147,60.2,0,0.0
VAUXHALL,CORSA,2008,306,124,40.5,182,59.5,0,0.0
VAUXHALL,CORSA,2009,286,122,42.7,164,57.3,0,0.0
VAUXHALL,CORSA,2010,292,128,43.8,164,56.2,0,0.0
VAUXHALL,CORSA,2011,182,92,50.5,90,49.5,1,0.5
VAUXHALL,CORSA,2012,279,186,66.7,93,33.3,0,0.0
VAUXHALL,CORSA,2013,126,82,65.1,44,34.9,0,0.0
VAUXHALL,CORSA,2014,243,170,70.0,73,30.0,0,0.0
VAUXHALL,CORSA,2015,8,6,75.0,2,25.0,0,0.0
VAUXHALL,CORSA,2016,2,1,50.0,1,50.0,0,0.0
VAUXHALL,CORSA CDTI CLUB 5DR,2007,2,1,50.0,1,50.0,0,0.0
VAUXHALL,FRONTERA,1992,1,1,100.0,0,0.0,0,0.0
VAUXHALL,FRONTERA,1999,1,0,0.0,1,100.0,0,0.0
VAUXHALL,FRONTERA,2003,1,1,100.0,0,0.0,0,0.0
VAUXHALL,INSIGNIA,2008,3,0,0.0,3,100.0,0,0.0
VAUXHALL,INSIGNIA,2009,627,261,41.6,366,58.4,0,0.0
VAUXHALL,INSIGNIA,2010,1278,633,49.5,645,50.5,1,0.1
VAUXHALL,INSIGNIA,2011,765,362,47.3,403,52.7,0,0.0
VAUXHALL,INSIGNIA,2012,1464,906,61.9,558,38.1,0,0.0
VAUXHALL,INSIGNIA,2013,327,239,73.1,88,26.9,0,0.0
VAUXHALL,INSIGNIA,2014,949,712,75.0,237,25.0,0,0.0
VAUXHALL,INSIGNIA,2015,61,49,80.3,12,19.7,0,0.0
VAUXHALL,INSIGNIA,2016,10,6,60.0,4,40.0,0,0.0
VAUXHALL,INSIGNIA,2017,2,1,50.0,1,50.0,0,0.0
VAUXHALL,MERIVA,2004,9,2,22.2,7,77.8,0,0.0
VAUXHALL,MERIVA,2005,21,3,14.3,18,85.7,0,0.0
VAUXHALL,MERIVA,2006,19,3,15.8,16,84.2,0,0.0
VAUXHALL,MERIVA,2007,28,7,25.0,21,75.0,0,0.0
VAUXHALL,MERIVA,2008,32,11,34.4,21,65.6,0,0.0
VAUXHALL,MERIVA,2009,18,5,27.8,13,72.2,0,0.0
VAUXHALL,MERIVA,2010,35,20,57.1,15,42.9,0,0.0
VAUXHALL,MERIVA,2011,41,31,75.6,10,24.4,0,0.0
VAUXHALL,MERIVA,2012,47,34,72.3,13,27.7,0,0.0
VAUXHALL,MERIVA,2013,4,3,75.0,1,25.0,0,0.0
VAUXHALL,MERIVA,2014,21,20,95.2,1,4.8,0,0.0
VAUXHALL,MERIVA,2015,1,1,100.0,0,0.0,0,0.0
VAUXHALL,MOKKA,2012,3,3,100.0,0,0.0,0,0.0
VAUXHALL,MOKKA,2013,27,20,74.1,7,25.9,0,0.0
VAUXHALL,MOKKA,2014,111,90,81.1,21,18.9,0,0.0
VAUXHALL,MOKKA,2015,10,7,70.0,3,30.0,0,0.0
VAUXHALL,MONARO,2004,1,0,0.0,1,100.0,0,0.0
VAUXHALL,MOVANO,2011,1,0,0.0,1,100.0,0,0.0
VAUXHALL,MOVANO,2012,1,0,0.0,1,100.0,0,0.0
VAUXHALL,OTHER,1985,1,0,0.0,1,100.0,0,0.0
VAUXHALL,OTHER,1990,5,2,40.0,3,60.0,0,0.0
VAUXHALL,OTHER,1991,3,1,33.3,2,66.7,0,0.0
VAUXHALL,OTHER,1992,2,1,50.0,1,50.0,0,0.0
VAUXHALL,OTHER,1993,2,0,0.0,2,100.0,0,0.0
VAUXHALL,OTHER,1994,4,2,50.0,2,50.0,0,0.0
VAUXHALL,OTHER,1995,5,2,40.0,3,60.0,0,0.0
VAUXHALL,OTHER,1996,8,7,87.5,1,12.5,0,0.0
VAUXHALL,OTHER,1997,6,4,66.7,2,33.3,0,0.0
VAUXHALL,OTHER,1998,6,2,33.3,4,66.7,0,0.0
VAUXHALL,OTHER,1999,8,1,12.5,7,87.5,0,0.0
VAUXHALL,OTHER,2000,33,15,45.5,18,54.5,0,0.0
VAUXHALL,OTHER,2001,83,18,21.7,65,78.3,0,0.0
VAUXHALL,OTHER,2002,149,42,28.2,107,71.8,0,0.0
VAUXHALL,OTHER,2003,197,58,29.4,139,70.6,0,0.0
VAUXHALL,OTHER,2004,269,74,27.5,195,72.5,0,0.0
VAUXHALL,OTHER,2005,247,64,25.9,183,74.1,0,0.0
VAUXHALL,OTHER,2006,152,46,30.3,106,69.7,0,0.0
VAUXHALL,OTHER,2007,122,45,36.9,77,63.1,0,0.0
VAUXHALL,OTHER,2008,51,19,37.3,32,62.7,0,0.0
VAUXHALL,OTHER,2009,21,10,47.6,11,52.4,0,0.0
VAUXHALL,OTHER,2010,9,5,55.6,4,44.4,0,0.0
VAUXHALL,OTHER,2012,1,1,100.0,0,0.0,0,0.0
VAUXHALL,OTHER,2013,3,0,0.0,3,100.0,0,0.0
VAUXHALL,SIGNIUM,2004,1,0,0.0,1,100.0,0,0.0
VAUXHALL,SIGNIUM,2005,1,0,0.0,1,100.0,0,0.0
VAUXHALL,SIGNIUM,2006,2,1,50.0,1,50.0,0,0.0
VAUXHALL,SIGNIUM,2007,1,0,0.0,1,100.0,0,0.0
VAUXHALL,TIGRA,2004,2,1,50.0,1,50.0,0,0.0
VAUXHALL,TIGRA,2005,1,0,0.0,1,100.0,0,0.0
VAUXHALL,TIGRA,2006,1,0,0.0,1,100.0,0,0.0
VAUXHALL,TIGRA,2007,1,0,0.0,1,100.0,0,0.0
VAUXHALL,TIGRA,2008,1,0,0.0,1,100.0,0,0.0
VAUXHALL,TIGRA,2009,4,2,50.0,2,50.0,0,0.0
VAUXHALL,VECTRA,1996,2,1,50.0,1,50.0,0,0.0
VAUXHALL,VECTRA,1997,1,1,100.0,0,0.0,0,0.0
VAUXHALL,VECTRA,1998,2,2,100.0,0,0.0,0,0.0
VAUXHALL,VECTRA,1999,2,0,0.0,2,100.0,0,0.0
VAUXHALL,VECTRA,2000,5,0,0.0,5,100.0,0,0.0
VAUXHALL,VECTRA,2001,11,4,36.4,7,63.6,0,0.0
VAUXHALL,VECTRA,2002,8,2,25.0,6,75.0,0,0.0
VAUXHALL,VECTRA,2003,25,6,24.0,19,76.0,0,0.0
VAUXHALL,VECTRA,2004,86,22,25.6,64,74.4,0,0.0
VAUXHALL,VECTRA,2005,167,37,22.2,130,77.8,0,0.0
VAUXHALL,VECTRA,2006,277,70,25.3,207,74.7,0,0.0
VAUXHALL,VECTRA,2007,328,98,29.9,230,70.1,0,0.0
VAUXHALL,VECTRA,2008,875,226,25.8,649,74.2,0,0.0
VAUXHALL,VECTRA,2009,180,54,30.0,126,70.0,0,0.0
VAUXHALL,VIVARO,2004,1,1,100.0,0,0.0,0,0.0
VAUXHALL,VIVARO,2005,1,1,100.0,0,0.0,0,0.0
VAUXHALL,VIVARO,2006,2,0,0.0,2,100.0,0,0.0
VAUXHALL,VIVARO,2008,1,1,100.0,0,0.0,0,0.0
VAUXHALL,VIVARO,2009,2,0,0.0,2,100.0,0,0.0
VAUXHALL,VIVARO,2010,10,1,10.0,9,90.0,0,0.0
VAUXHALL,VIVARO,2011,5,2,40.0,3,60.0,0,0.0
VAUXHALL,VIVARO,2012,4,4,100.0,0,0.0,0,0.0
VAUXHALL,VIVARO,2013,10,6,60.0,4,40.0,0,0.0
VAUXHALL,VIVARO,2014,13,8,61.5,5,38.5,0,0.0
VAUXHALL,VIVARO,2015,4,2,50.0,2,50.0,0,0.0
VAUXHALL,VIVARO,2016,4,4,100.0,0,0.0,0,0.0
VAUXHALL,VX220,2003,1,1,100.0,0,0.0,0,0.0
VAUXHALL,VX220,2006,1,1,100.0,0,0.0,0,0.0
VAUXHALL,VXR8,2008,1,1,100.0,0,0.0,0,0.0
VAUXHALL,ZAFIRA,2000,2,1,50.0,1,50.0,0,0.0
VAUXHALL,ZAFIRA,2001,3,2,66.7,1,33.3,0,0.0
VAUXHALL,ZAFIRA,2002,12,7,58.3,5,41.7,0,0.0
VAUXHALL,ZAFIRA,2003,16,7,43.8,9,56.3,0,0.0
VAUXHALL,ZAFIRA,2004,35,6,17.1,29,82.9,0,0.0
VAUXHALL,ZAFIRA,2005,71,15,21.1,56,78.9,0,0.0
VAUXHALL,ZAFIRA,2006,206,48,23.3,158,76.7,0,0.0
VAUXHALL,ZAFIRA,2007,188,52,27.7,136,72.3,0,0.0
VAUXHALL,ZAFIRA,2008,204,52,25.5,152,74.5,0,0.0
VAUXHALL,ZAFIRA,2009,85,19,22.4,66,77.6,0,0.0
VAUXHALL,ZAFIRA,2010,315,107,34.0,208,66.0,0,0.0
VAUXHALL,ZAFIRA,2011,138,59,42.8,79,57.2,0,0.0
VAUXHALL,ZAFIRA,2012,224,118,52.7,106,47.3,0,0.0
VAUXHALL,ZAFIRA,2013,99,66,66.7,33,33.3,0,0.0
VAUXHALL,ZAFIRA,2014,360,268,74.4,92,25.6,0,0.0
VAUXHALL,ZAFIRA,2015,24,20,83.3,4,16.7,0,0.0
VAUXHALL,ZAFIRA,2016,1,1,100.0,0,0.0,0,0.0
VAUXHALL,ZAFIRA 1.8 COMFORT 16V 5DR,2005,3,1,33.3,2,66.7,0,0.0
VAUXHALL,ZAFIRA 1.8 COMFORT 16V 5DR,2007,1,0,0.0,1,100.0,0,0.0
VAUXHALL,ZAFIRA 1.8 COMFORT 16V 5DR,2008,1,0,0.0,1,100.0,0,0.0
VAUXHALL,ZAFIRA 1.8 COMFORT 16V 5DR,2009,1,1,100.0,0,0.0,0,0.0
VAUXHALL,ZAFIRA LIFE 16V,2005,1,1,100.0,0,0.0,0,0.0
VINTAGE MOTOR COMPANY,BARNSDALE,2005,2,0,0.0,2,100.0,0,0.0
VOLKSWAGEN,1200,1977,1,0,0.0,1,100.0,0,0.0
VOLKSWAGEN,1200,2000,2,0,0.0,2,100.0,0,0.0
VOLKSWAGEN,1200,2001,9,1,11.1,8,88.9,0,0.0
VOLKSWAGEN,1200,2002,11,6,54.5,5,45.5,0,0.0
VOLKSWAGEN,1200,2003,13,3,23.1,10,76.9,0,0.0
VOLKSWAGEN,BEETLE,1998,1,1,100.0,0,0.0,0,0.0
VOLKSWAGEN,BEETLE,1999,2,1,50.0,1,50.0,0,0.0
VOLKSWAGEN,BEETLE,2000,84,35,41.7,49,58.3,0,0.0
VOLKSWAGEN,BEETLE,2001,162,43,26.5,119,73.5,0,0.0
VOLKSWAGEN,BEETLE,2002,151,56,37.1,95,62.9,0,0.0
VOLKSWAGEN,BEETLE,2003,193,67,34.7,126,65.3,0,0.0
VOLKSWAGEN,BEETLE,2004,303,115,38.0,188,62.0,0,0.0
VOLKSWAGEN,BEETLE,2005,286,125,43.7,161,56.3,0,0.0
VOLKSWAGEN,BEETLE,2006,259,128,49.4,131,50.6,0,0.0
VOLKSWAGEN,BEETLE,2007,293,157,53.6,136,46.4,0,0.0
VOLKSWAGEN,BEETLE,2008,113,59,52.2,54,47.8,0,0.0
VOLKSWAGEN,BEETLE,2009,20,9,45.0,11,55.0,0,0.0
VOLKSWAGEN,BEETLE,2010,28,17,60.7,11,39.3,0,0.0
VOLKSWAGEN,BEETLE,2011,2,2,100.0,0,0.0,0,0.0
VOLKSWAGEN,BEETLE,2012,71,53,74.6,18,25.4,0,0.0
VOLKSWAGEN,BEETLE,2013,49,41,83.7,8,16.3,0,0.0
VOLKSWAGEN,BEETLE,2014,178,146,82.0,32,18.0,0,0.0
VOLKSWAGEN,BEETLE,2015,3,3,100.0,0,0.0,0,0.0
VOLKSWAGEN,BORA,1999,84,24,28.6,60,71.4,0,0.0
VOLKSWAGEN,BORA,2000,278,85,30.6,193,69.4,0,0.0
VOLKSWAGEN,BORA,2001,431,149,34.6,282,65.4,0,0.0
VOLKSWAGEN,BORA,2002,676,191,28.3,485,71.7,0,0.0
VOLKSWAGEN,BORA,2003,922,272,29.5,650,70.5,1,0.1
VOLKSWAGEN,BORA,2004,973,316,32.5,657,67.5,0,0.0
VOLKSWAGEN,BORA,2005,623,224,36.0,399,64.0,0,0.0
VOLKSWAGEN,BORA,2006,34,12,35.3,22,64.7,0,0.0
VOLKSWAGEN,BORA 1.9 TDI SE 115BHP 4DR,2001,1,0,0.0,1,100.0,0,0.0
VOLKSWAGEN,CADDY,2004,3,0,0.0,3,100.0,0,0.0
VOLKSWAGEN,CADDY,2005,37,14,37.8,23,62.2,0,0.0
VOLKSWAGEN,CADDY,2006,28,13,46.4,15,53.6,0,0.0
VOLKSWAGEN,CADDY,2007,18,7,38.9,11,61.1,0,0.0
VOLKSWAGEN,CADDY,2008,30,11,36.7,19,63.3,0,0.0
VOLKSWAGEN,CADDY,2009,12,4,33.3,8,66.7,0,0.0
VOLKSWAGEN,CADDY,2010,51,29,56.9,22,43.1,0,0.0
VOLKSWAGEN,CADDY,2011,40,25,62.5,15,37.5,0,0.0
VOLKSWAGEN,CADDY,2012,133,97,72.9,36,27.1,2,1.5
VOLKSWAGEN,CADDY,2013,93,64,68.8,29,31.2,5,5.4
VOLKSWAGEN,CADDY,2014,121,85,70.2,36,29.8,8,6.6
VOLKSWAGEN,CADDY,2015,55,33,60.0,22,40.0,7,12.7
VOLKSWAGEN,CADDY,2016,56,29,51.8,27,48.2,7,12.5
VOLKSWAGEN,CADDY,2017,53,36,67.9,17,32.1,6,11.3
VOLKSWAGEN,CADDY,2018,13,6,46.2,7,53.8,1,7.7
VOLKSWAGEN,CADDY 1.9D,2008,4,2,50.0,2,50.0,0,0.0
VOLKSWAGEN,CADDY 1.9D,2009,6,5,83.3,1,16.7,0,0.0
VOLKSWAGEN,CADDY 1.9D,2010,18,11,61.1,7,38.9,0,0.0
VOLKSWAGEN,CADDY 1.9D,2011,5,1,20.0,4,80.0,1,20.0
VOLKSWAGEN,CADDY 1.9D,2012,9,8,88.9,1,11.1,0,0.0
VOLKSWAGEN,CADDY 1.9D,2013,3,2,66.7,1,33.3,0,0.0
VOLKSWAGEN,CADDY 1.9D,2014,10,7,70.0,3,30.0,2,20.0
VOLKSWAGEN,CADDY 1.9D,2015,5,2,40.0,3,60.0,1,20.0
VOLKSWAGEN,CADDY MAXI LIFE 1.6 5DR,2011,1,0,0.0,1,100.0,1,100.0
VOLKSWAGEN,CADDY MAXI LIFE 1.6 5DR,2012,1,1,100.0,0,0.0,0,0.0
VOLKSWAGEN,CALIFORNIA,2014,1,0,0.0,1,100.0,0,0.0
VOLKSWAGEN,CARAVELLE,1999,1,0,0.0,1,100.0,0,0.0
VOLKSWAGEN,CARAVELLE,2000,3,1,33.3,2,66.7,0,0.0
VOLKSWAGEN,CARAVELLE,2001,1,0,0.0,1,100.0,0,0.0
VOLKSWAGEN,CARAVELLE,2002,3,1,33.3,2,66.7,0,0.0
VOLKSWAGEN,CARAVELLE,2003,3,1,33.3,2,66.7,0,0.0
VOLKSWAGEN,CARAVELLE,2004,1,1,100.0,0,0.0,0,0.0
VOLKSWAGEN,CARAVELLE,2005,4,3,75.0,1,25.0,0,0.0
VOLKSWAGEN,CARAVELLE,2006,3,1,33.3,2,66.7,0,0.0
VOLKSWAGEN,CARAVELLE,2007,5,1,20.0,4,80.0,1,20.0
VOLKSWAGEN,CARAVELLE,2008,2,0,0.0,2,100.0,0,0.0
VOLKSWAGEN,CARAVELLE,2009,3,1,33.3,2,66.7,0,0.0
VOLKSWAGEN,CARAVELLE,2010,7,4,57.1,3,42.9,0,0.0
VOLKSWAGEN,CARAVELLE,2011,2,1,50.0,1,50.0,0,0.0
VOLKSWAGEN,CARAVELLE,2012,11,11,100.0,0,0.0,0,0.0
VOLKSWAGEN,CARAVELLE,2013,12,12,100.0,0,0.0,0,0.0
VOLKSWAGEN,CARAVELLE,2014,25,19,76.0,6,24.0,1,4.0
VOLKSWAGEN,CARAVELLE,2015,4,4,100.0,0,0.0,0,0.0
VOLKSWAGEN,CARAVELLE,2017,1,1,100.0,0,0.0,0,0.0
VOLKSWAGEN,CC,2010,2,1,50.0,1,50.0,0,0.0
VOLKSWAGEN,CC,2011,50,39,78.0,11,22.0,0,0.0
VOLKSWAGEN,CC,2012,443,292,65.9,151,34.1,0,0.0
VOLKSWAGEN,CC,2013,306,228,74.5,78,25.5,0,0.0
VOLKSWAGEN,CC,2014,777,586,75.4,191,24.6,0,0.0
VOLKSWAGEN,CC,2015,29,21,72.4,8,27.6,0,0.0
VOLKSWAGEN,CC,2016,3,2,66.7,1,33.3,0,0.0
VOLKSWAGEN,CORRADO,1989,2,0,0.0,2,100.0,0,0.0
VOLKSWAGEN,CORRADO,1990,6,2,33.3,4,66.7,0,0.0
VOLKSWAGEN,CORRADO,1991,4,1,25.0,3,75.0,0,0.0
VOLKSWAGEN,CORRADO,1992,9,4,44.4,5,55.6,0,0.0
VOLKSWAGEN,CORRADO,1993,2,0,0.0,2,100.0,0,0.0
VOLKSWAGEN,CORRADO,1994,6,2,33.3,4,66.7,0,0.0
VOLKSWAGEN,CORRADO,1995,11,4,36.4,7,63.6,0,0.0
VOLKSWAGEN,CORRADO,1996,5,1,20.0,4,80.0,0,0.0
VOLKSWAGEN,CRAFTER,2007,1,0,0.0,1,100.0,0,0.0
VOLKSWAGEN,CRAFTER,2010,1,0,0.0,1,100.0,0,0.0
VOLKSWAGEN,CRAFTER 35MWB HR 80KW TDI 6SP,2008,1,0,0.0,1,100.0,0,0.0
VOLKSWAGEN,E-GOLF,2014,3,3,100.0,0,0.0,0,0.0
VOLKSWAGEN,EOS,2006,36,13,36.1,23,63.9,0,0.0
VOLKSWAGEN,EOS,2007,164,75,45.7,89,54.3,0,0.0
VOLKSWAGEN,EOS,2008,66,37,56.1,29,43.9,0,0.0
VOLKSWAGEN,EOS,2009,3,2,66.7,1,33.3,0,0.0
VOLKSWAGEN,EOS,2010,12,8,66.7,4,33.3,0,0.0
VOLKSWAGEN,EOS,2012,1,1,100.0,0,0.0,0,0.0
VOLKSWAGEN,EOS,2013,1,1,100.0,0,0.0,0,0.0
VOLKSWAGEN,FOX,2006,156,89,57.1,67,42.9,0,0.0
VOLKSWAGEN,FOX,2007,299,135,45.2,164,54.8,0,0.0
VOLKSWAGEN,FOX,2008,114,49,43.0,65,57.0,0,0.0
VOLKSWAGEN,FOX,2009,33,19,57.6,14,42.4,0,0.0
VOLKSWAGEN,FOX,2010,150,88,58.7,62,41.3,0,0.0
VOLKSWAGEN,FOX,2011,14,10,71.4,4,28.6,0,0.0
VOLKSWAGEN,FOX,2012,2,1,50.0,1,50.0,0,0.0
VOLKSWAGEN,GOLF,1980,4,1,25.0,3,75.0,0,0.0
VOLKSWAGEN,GOLF,1981,1,1,100.0,0,0.0,0,0.0
VOLKSWAGEN,GOLF,1982,7,2,28.6,5,71.4,0,0.0
VOLKSWAGEN,GOLF,1983,18,9,50.0,9,50.0,0,0.0
VOLKSWAGEN,GOLF,1984,8,1,12.5,7,87.5,0,0.0
VOLKSWAGEN,GOLF,1985,12,7,58.3,5,41.7,0,0.0
VOLKSWAGEN,GOLF,1986,17,5,29.4,12,70.6,0,0.0
VOLKSWAGEN,GOLF,1987,11,7,63.6,4,36.4,0,0.0
VOLKSWAGEN,GOLF,1988,9,3,33.3,6,66.7,0,0.0
VOLKSWAGEN,GOLF,1989,34,13,38.2,21,61.8,0,0.0
VOLKSWAGEN,GOLF,1990,68,28,41.2,40,58.8,0,0.0
VOLKSWAGEN,GOLF,1991,89,26,29.2,63,70.8,0,0.0
VOLKSWAGEN,GOLF,1992,27,9,33.3,18,66.7,0,0.0
VOLKSWAGEN,GOLF,1993,14,3,21.4,11,78.6,0,0.0
VOLKSWAGEN,GOLF,1994,28,9,32.1,19,67.9,0,0.0
VOLKSWAGEN,GOLF,1995,58,11,19.0,47,81.0,0,0.0
VOLKSWAGEN,GOLF,1996,121,39,32.2,82,67.8,0,0.0
VOLKSWAGEN,GOLF,1997,132,33,25.0,99,75.0,1,0.8
VOLKSWAGEN,GOLF,1998,209,59,28.2,150,71.8,0,0.0
VOLKSWAGEN,GOLF,1999,446,131,29.4,315,70.6,0,0.0
VOLKSWAGEN,GOLF,2000,1148,362,31.5,786,68.5,0,0.0
VOLKSWAGEN,GOLF,2001,1775,567,31.9,1208,68.1,0,0.0
VOLKSWAGEN,GOLF,2002,3235,1002,31.0,2233,69.0,0,0.0
VOLKSWAGEN,GOLF,2003,4251,1375,32.3,2876,67.7,0,0.0
VOLKSWAGEN,GOLF,2004,5800,1958,33.8,3842,66.2,1,0.0
VOLKSWAGEN,GOLF,2005,7051,2742,38.9,4309,61.1,0,0.0
VOLKSWAGEN,GOLF,2006,6985,3118,44.6,3867,55.4,1,0.0
VOLKSWAGEN,GOLF,2007,7280,3834,52.7,3446,47.3,0,0.0
VOLKSWAGEN,GOLF,2008,5985,3109,51.9,2876,48.1,3,0.1
VOLKSWAGEN,GOLF,2009,2048,1196,58.4,852,41.6,1,0.0
VOLKSWAGEN,GOLF,2010,5780,3882,67.2,1898,32.8,4,0.1
VOLKSWAGEN,GOLF,2011,1802,1214,67.4,588,32.6,0,0.0
VOLKSWAGEN,GOLF,2012,5000,3855,77.1,1145,22.9,2,0.0
VOLKSWAGEN,GOLF,2013,1305,1034,79.2,271,20.8,0,0.0
VOLKSWAGEN,GOLF,2014,5880,5010,85.2,870,14.8,1,0.0
VOLKSWAGEN,GOLF,2015,571,503,88.1,68,11.9,0,0.0
VOLKSWAGEN,GOLF,2016,31,18,58.1,13,41.9,0,0.0
VOLKSWAGEN,GOLF,2017,1,1,100.0,0,0.0,0,0.0
VOLKSWAGEN,GOLF 1.6 TDI S 90PS 5DR,2010,5,1,20.0,4,80.0,0,0.0
VOLKSWAGEN,GOLF 1.8 CLIPPER 2DR,1992,1,0,0.0,1,100.0,0,0.0
VOLKSWAGEN,GOLF 1.8 GL 90BHP 5DR,1992,1,1,100.0,0,0.0,0,0.0
VOLKSWAGEN,GOLF 1.8 GTI 16V,1985,1,0,0.0,1,100.0,0,0.0
VOLKSWAGEN,GOLF 1.8 GTI 16V,1986,1,0,0.0,1,100.0,0,0.0
VOLKSWAGEN,GOLF 1.8 GTI 16V,1990,4,2,50.0,2,50.0,0,0.0
VOLKSWAGEN,GOLF 1.8 GTI 16V,1991,3,2,66.7,1,33.3,0,0.0
VOLKSWAGEN,GOLF 1.8 GTI 16V,1992,1,1,100.0,0,0.0,0,0.0
VOLKSWAGEN,GOLF 1.8 GTI 16V,1993,1,0,0.0,1,100.0,0,0.0
VOLKSWAGEN,GOLF 1.8 GTI 16V,1995,2,0,0.0,2,100.0,0,0.0
VOLKSWAGEN,GOLF 1.8 GTI 16V,1997,2,1,50.0,1,50.0,0,0.0
VOLKSWAGEN,GOLF 1.8 GTI 16V,2001,6,3,50.0,3,50.0,0,0.0
VOLKSWAGEN,GOLF 1.8 GTI 16V,2002,4,1,25.0,3,75.0,0,0.0
VOLKSWAGEN,GOLF 1.8 GTI 16V,2003,4,1,25.0,3,75.0,0,0.0
VOLKSWAGEN,GOLF 1.8 GTI 16V,2004,2,0,0.0,2,100.0,0,0.0
VOLKSWAGEN,GOLF 1.8 GTI 8V 5DR,1985,1,0,0.0,1,100.0,0,0.0
VOLKSWAGEN,GOLF 1.8 GTI TURBO 150BHP 5DR,1999,2,1,50.0,1,50.0,0,0.0
VOLKSWAGEN,GOLF 1.8 GTI TURBO 20V,2000,1,1,100.0,0,0.0,0,0.0
VOLKSWAGEN,GOLF 1.8GTI 25TH AN EDIT,1982,1,1,100.0,0,0.0,0,0.0
VOLKSWAGEN,GOLF 1.8GTI 25TH AN EDIT,1983,8,3,37.5,5,62.5,0,0.0
VOLKSWAGEN,GOLF 1.8GTI 25TH AN EDIT,1984,2,0,0.0,2,100.0,0,0.0
VOLKSWAGEN,GOLF 1.8GTI 25TH AN EDIT,1985,3,1,33.3,2,66.7,0,0.0
VOLKSWAGEN,GOLF 1.8GTI 25TH AN EDIT,1986,1,0,0.0,1,100.0,0,0.0
VOLKSWAGEN,GOLF 1.8GTI 25TH AN EDIT,1987,3,0,0.0,3,100.0,0,0.0
VOLKSWAGEN,GOLF 1.8GTI 25TH AN EDIT,1988,2,0,0.0,2,100.0,0,0.0
VOLKSWAGEN,GOLF 1.8GTI 25TH AN EDIT,1989,2,0,0.0,2,100.0,0,0.0
VOLKSWAGEN,GOLF 1.8GTI 25TH AN EDIT,1990,5,2,40.0,3,60.0,0,0.0
VOLKSWAGEN,GOLF 1.8GTI 25TH AN EDIT,1991,7,3,42.9,4,57.1,0,0.0
VOLKSWAGEN,GOLF 1.8GTI 25TH AN EDIT,1994,1,0,0.0,1,100.0,0,0.0
VOLKSWAGEN,GOLF 1.8GTI 25TH AN EDIT,1996,1,1,100.0,0,0.0,0,0.0
VOLKSWAGEN,GOLF 1.8GTI 25TH AN EDIT,1998,1,1,100.0,0,0.0,0,0.0
VOLKSWAGEN,GOLF 1.8GTI 25TH AN EDIT,1999,4,4,100.0,0,0.0,0,0.0
VOLKSWAGEN,GOLF 1.8GTI 25TH AN EDIT,2000,2,2,100.0,0,0.0,0,0.0
VOLKSWAGEN,GOLF 1.8GTI 25TH AN EDIT,2001,5,3,60.0,2,40.0,0,0.0
VOLKSWAGEN,GOLF 1.8GTI 25TH AN EDIT,2002,15,8,53.3,7,46.7,0,0.0
VOLKSWAGEN,GOLF 1.8GTI 25TH AN EDIT,2003,3,1,33.3,2,66.7,0,0.0
VOLKSWAGEN,GOLF 1.8GTI 25TH AN EDIT,2004,2,1,50.0,1,50.0,0,0.0
VOLKSWAGEN,GOLF 1.9 GT TDI 130BHP 5DR,2003,2,0,0.0,2,100.0,0,0.0
VOLKSWAGEN,GOLF 1.9 GTI TDI 150BHP 5DR,2003,1,0,0.0,1,100.0,0,0.0
VOLKSWAGEN,GOLF 1.9D GT TDI 130BHP 5DR,2002,1,0,0.0,1,100.0,0,0.0
VOLKSWAGEN,GOLF 1.9D TDI MATCH 105BHP,2008,1,0,0.0,1,100.0,0,0.0
VOLKSWAGEN,GOLF 1.9D TDI S 105BHP 5DR,2006,1,0,0.0,1,100.0,0,0.0
VOLKSWAGEN,GOLF 1.9D TDI SE 100BHP 5DR,2002,1,0,0.0,1,100.0,0,0.0
VOLKSWAGEN,GOLF 1.9D TDI SE 100BHP 5DR,2008,2,1,50.0,1,50.0,0,0.0
VOLKSWAGEN,GOLF 2.0 GT TDI 140BHP 5DR,2005,1,1,100.0,0,0.0,0,0.0
VOLKSWAGEN,GOLF ANNIVERSARY 1.9D TDI 3DR,2002,1,0,0.0,1,100.0,0,0.0
VOLKSWAGEN,GOLF GT TDI,2001,1,0,0.0,1,100.0,0,0.0
VOLKSWAGEN,GOLF GT TDI,2002,3,1,33.3,2,66.7,0,0.0
VOLKSWAGEN,GOLF GTI 16V,1997,1,0,0.0,1,100.0,0,0.0
VOLKSWAGEN,GOLF GTI 200PS,2005,1,1,100.0,0,0.0,0,0.0
VOLKSWAGEN,GOLF PLUS,2005,8,4,50.0,4,50.0,0,0.0
VOLKSWAGEN,GOLF PLUS,2006,22,12,54.5,10,45.5,0,0.0
VOLKSWAGEN,GOLF PLUS,2007,17,5,29.4,12,70.6,0,0.0
VOLKSWAGEN,GOLF PLUS,2008,22,12,54.5,10,45.5,0,0.0
VOLKSWAGEN,GOLF PLUS,2009,40,21,52.5,19,47.5,0,0.0
VOLKSWAGEN,GOLF PLUS,2010,29,20,69.0,9,31.0,0,0.0
VOLKSWAGEN,GOLF PLUS,2011,15,10,66.7,5,33.3,0,0.0
VOLKSWAGEN,GOLF PLUS,2012,10,7,70.0,3,30.0,0,0.0
VOLKSWAGEN,GOLF PLUS,2013,8,7,87.5,1,12.5,0,0.0
VOLKSWAGEN,GOLF PLUS,2014,8,7,87.5,1,12.5,0,0.0
VOLKSWAGEN,JETTA,1981,1,0,0.0,1,100.0,0,0.0
VOLKSWAGEN,JETTA,1983,3,0,0.0,3,100.0,0,0.0
VOLKSWAGEN,JETTA,1984,6,1,16.7,5,83.3,0,0.0
VOLKSWAGEN,JETTA,1985,1,0,0.0,1,100.0,0,0.0
VOLKSWAGEN,JETTA,1986,4,4,100.0,0,0.0,0,0.0
VOLKSWAGEN,JETTA,1987,1,0,0.0,1,100.0,0,0.0
VOLKSWAGEN,JETTA,1988,6,4,66.7,2,33.3,0,0.0
VOLKSWAGEN,JETTA,1989,7,2,28.6,5,71.4,0,0.0
VOLKSWAGEN,JETTA,1990,27,7,25.9,20,74.1,0,0.0
VOLKSWAGEN,JETTA,1991,29,9,31.0,20,69.0,0,0.0
VOLKSWAGEN,JETTA,1992,22,7,31.8,15,68.2,0,0.0
VOLKSWAGEN,JETTA,2004,1,1,100.0,0,0.0,0,0.0
VOLKSWAGEN,JETTA,2005,21,7,33.3,14,66.7,0,0.0
VOLKSWAGEN,JETTA,2006,1655,607,36.7,1048,63.3,0,0.0
VOLKSWAGEN,JETTA,2007,1831,804,43.9,1027,56.1,1,0.1
VOLKSWAGEN,JETTA,2008,1314,666,50.7,648,49.3,0,0.0
VOLKSWAGEN,JETTA,2009,382,193,50.5,189,49.5,0,0.0
VOLKSWAGEN,JETTA,2010,1047,595,56.8,452,43.2,0,0.0
VOLKSWAGEN,JETTA,2011,117,66,56.4,51,43.6,0,0.0
VOLKSWAGEN,JETTA,2012,916,684,74.7,232,25.3,0,0.0
VOLKSWAGEN,JETTA,2013,150,111,74.0,39,26.0,0,0.0
VOLKSWAGEN,JETTA,2014,826,651,78.8,175,21.2,0,0.0
VOLKSWAGEN,JETTA,2015,121,98,81.0,23,19.0,0,0.0
VOLKSWAGEN,JETTA,2016,3,2,66.7,1,33.3,0,0.0
VOLKSWAGEN,JETTA,2017,1,1,100.0,0,0.0,0,0.0
VOLKSWAGEN,JETTA 1.6 FSI C/LINE 115BHP 4D,2007,1,1,100.0,0,0.0,0,0.0
VOLKSWAGEN,JETTA II GL 19E LHD 4DR,1988,1,0,0.0,1,100.0,0,0.0
VOLKSWAGEN,KOMBI,1968,1,0,0.0,1,100.0,0,0.0
VOLKSWAGEN,KOMBI,1974,1,0,0.0,1,100.0,0,0.0
VOLKSWAGEN,KOMBI,1975,1,0,0.0,1,100.0,0,0.0
VOLKSWAGEN,KOMBI,2016,31,25,80.6,6,19.4,0,0.0
VOLKSWAGEN,KOMBI,2017,46,34,73.9,12,26.1,1,2.2
VOLKSWAGEN,KOMBI,2018,9,8,88.9,1,11.1,0,0.0
VOLKSWAGEN,LUPO,1999,36,20,55.6,16,44.4,0,0.0
VOLKSWAGEN,LUPO,2000,112,52,46.4,60,53.6,0,0.0
VOLKSWAGEN,LUPO,2001,87,38,43.7,49,56.3,0,0.0
VOLKSWAGEN,LUPO,2002,91,44,48.4,47,51.6,0,0.0
VOLKSWAGEN,LUPO,2003,45,29,64.4,16,35.6,0,0.0
VOLKSWAGEN,LUPO,2004,47,24,51.1,23,48.9,0,0.0
VOLKSWAGEN,LUPO,2005,34,24,70.6,10,29.4,0,0.0
VOLKSWAGEN,LUPO,2006,2,1,50.0,1,50.0,0,0.0
VOLKSWAGEN,MULTIVAN,2003,1,1,100.0,0,0.0,0,0.0
VOLKSWAGEN,MULTIVAN,2006,1,0,0.0,1,100.0,0,0.0
VOLKSWAGEN,MULTIVAN,2016,1,1,100.0,0,0.0,0,0.0
VOLKSWAGEN,OTHER,1985,1,0,0.0,1,100.0,0,0.0
VOLKSWAGEN,OTHER,1987,2,0,0.0,2,100.0,0,0.0
VOLKSWAGEN,OTHER,1988,1,0,0.0,1,100.0,0,0.0
VOLKSWAGEN,OTHER,1992,1,1,100.0,0,0.0,0,0.0
VOLKSWAGEN,OTHER,1994,3,0,0.0,3,100.0,0,0.0
VOLKSWAGEN,OTHER,1995,7,2,28.6,5,71.4,0,0.0
VOLKSWAGEN,OTHER,1996,3,0,0.0,3,100.0,0,0.0
VOLKSWAGEN,OTHER,1997,5,0,0.0,5,100.0,0,0.0
VOLKSWAGEN,OTHER,1998,17,5,29.4,12,70.6,0,0.0
VOLKSWAGEN,OTHER,1999,20,6,30.0,14,70.0,0,0.0
VOLKSWAGEN,OTHER,2000,21,4,19.0,17,81.0,0,0.0
VOLKSWAGEN,OTHER,2001,38,16,42.1,22,57.9,0,0.0
VOLKSWAGEN,OTHER,2002,41,13,31.7,28,68.3,0,0.0
VOLKSWAGEN,OTHER,2003,49,12,24.5,37,75.5,0,0.0
VOLKSWAGEN,OTHER,2004,191,54,28.3,137,71.7,0,0.0
VOLKSWAGEN,OTHER,2005,257,81,31.5,176,68.5,0,0.0
VOLKSWAGEN,OTHER,2006,210,62,29.5,148,70.5,0,0.0
VOLKSWAGEN,OTHER,2007,80,34,42.5,46,57.5,1,1.3
VOLKSWAGEN,OTHER,2008,62,28,45.2,34,54.8,0,0.0
VOLKSWAGEN,OTHER,2009,9,3,33.3,6,66.7,0,0.0
VOLKSWAGEN,OTHER,2010,31,14,45.2,17,54.8,1,3.2
VOLKSWAGEN,OTHER,2012,1,0,0.0,1,100.0,0,0.0
VOLKSWAGEN,PASSAT,1982,2,1,50.0,1,50.0,0,0.0
VOLKSWAGEN,PASSAT,1985,2,1,50.0,1,50.0,0,0.0
VOLKSWAGEN,PASSAT,1987,3,1,33.3,2,66.7,0,0.0
VOLKSWAGEN,PASSAT,1988,2,0,0.0,2,100.0,0,0.0
VOLKSWAGEN,PASSAT,1991,2,0,0.0,2,100.0,0,0.0
VOLKSWAGEN,PASSAT,1992,2,1,50.0,1,50.0,0,0.0
VOLKSWAGEN,PASSAT,1993,2,1,50.0,1,50.0,0,0.0
VOLKSWAGEN,PASSAT,1994,4,1,25.0,3,75.0,0,0.0
VOLKSWAGEN,PASSAT,1995,8,1,12.5,7,87.5,0,0.0
VOLKSWAGEN,PASSAT,1996,5,0,0.0,5,100.0,0,0.0
VOLKSWAGEN,PASSAT,1997,20,6,30.0,14,70.0,0,0.0
VOLKSWAGEN,PASSAT,1998,95,25,26.3,70,73.7,0,0.0
VOLKSWAGEN,PASSAT,1999,196,67,34.2,129,65.8,1,0.5
VOLKSWAGEN,PASSAT,2000,361,92,25.5,269,74.5,0,0.0
VOLKSWAGEN,PASSAT,2001,652,171,26.2,481,73.8,0,0.0
VOLKSWAGEN,PASSAT,2002,1342,373,27.8,969,72.2,0,0.0
VOLKSWAGEN,PASSAT,2003,2362,628,26.6,1734,73.4,0,0.0
VOLKSWAGEN,PASSAT,2004,3244,942,29.0,2302,71.0,0,0.0
VOLKSWAGEN,PASSAT,2005,3856,1292,33.5,2564,66.5,1,0.0
VOLKSWAGEN,PASSAT,2006,7321,2633,36.0,4688,64.0,4,0.1
VOLKSWAGEN,PASSAT,2007,6960,2922,42.0,4038,58.0,1,0.0
VOLKSWAGEN,PASSAT,2008,5432,2455,45.2,2977,54.8,2,0.0
VOLKSWAGEN,PASSAT,2009,1943,887,45.7,1056,54.3,1,0.1
VOLKSWAGEN,PASSAT,2010,3461,1880,54.3,1581,45.7,0,0.0
VOLKSWAGEN,PASSAT,2011,1639,999,61.0,640,39.0,1,0.1
VOLKSWAGEN,PASSAT,2012,4178,3014,72.1,1164,27.9,4,0.1
VOLKSWAGEN,PASSAT,2013,747,551,73.8,196,26.2,0,0.0
VOLKSWAGEN,PASSAT,2014,3270,2635,80.6,635,19.4,0,0.0
VOLKSWAGEN,PASSAT,2015,232,184,79.3,48,20.7,0,0.0
VOLKSWAGEN,PASSAT,2016,23,17,73.9,6,26.1,0,0.0
VOLKSWAGEN,PASSAT,2017,6,6,100.0,0,0.0,0,0.0
VOLKSWAGEN,PASSAT,2018,1,1,100.0,0,0.0,0,0.0
VOLKSWAGEN,PASSAT 1.9 TDI S 105BHP 4DR,2007,1,0,0.0,1,100.0,0,0.0
VOLKSWAGEN,PASSAT 2.0 TDI SE 140BHP 4DR,2005,1,0,0.0,1,100.0,0,0.0
VOLKSWAGEN,PASSAT D 1.9 TDI T/LINE 130BHP,2005,1,0,0.0,1,100.0,0,0.0
VOLKSWAGEN,PASSAT D 1.9TDI SPORT 130BHP,2003,1,1,100.0,0,0.0,0,0.0
VOLKSWAGEN,PASSAT D 1.9TDI T/LINE 100BHP,2005,1,0,0.0,1,100.0,0,0.0
VOLKSWAGEN,PASSAT SPORT 130BHP,2004,1,0,0.0,1,100.0,0,0.0
VOLKSWAGEN,PASSAT SPORT 130BHP,2006,1,0,0.0,1,100.0,0,0.0
VOLKSWAGEN,PHAETON,2003,1,1,100.0,0,0.0,0,0.0
VOLKSWAGEN,PHAETON,2004,2,1,50.0,1,50.0,0,0.0
VOLKSWAGEN,PHAETON,2005,5,3,60.0,2,40.0,0,0.0
VOLKSWAGEN,PHAETON,2006,5,3,60.0,2,40.0,0,0.0
VOLKSWAGEN,PHAETON,2007,3,3,100.0,0,0.0,0,0.0
VOLKSWAGEN,PHAETON,2008,2,2,100.0,0,0.0,0,0.0
VOLKSWAGEN,PHAETON,2010,1,1,100.0,0,0.0,0,0.0
VOLKSWAGEN,PHAETON,2012,3,3,100.0,0,0.0,0,0.0
VOLKSWAGEN,POLO,1989,3,1,33.3,2,66.7,0,0.0
VOLKSWAGEN,POLO,1990,9,1,11.1,8,88.9,0,0.0
VOLKSWAGEN,POLO,1991,12,6,50.0,6,50.0,0,0.0
VOLKSWAGEN,POLO,1992,5,2,40.0,3,60.0,0,0.0
VOLKSWAGEN,POLO,1993,5,2,40.0,3,60.0,0,0.0
VOLKSWAGEN,POLO,1994,1,0,0.0,1,100.0,0,0.0
VOLKSWAGEN,POLO,1995,40,14,35.0,26,65.0,0,0.0
VOLKSWAGEN,POLO,1996,103,48,46.6,55,53.4,0,0.0
VOLKSWAGEN,POLO,1997,222,79,35.6,143,64.4,0,0.0
VOLKSWAGEN,POLO,1998,137,52,38.0,85,62.0,0,0.0
VOLKSWAGEN,POLO,1999,313,107,34.2,206,65.8,0,0.0
VOLKSWAGEN,POLO,2000,1541,502,32.6,1039,67.4,0,0.0
VOLKSWAGEN,POLO,2001,1267,391,30.9,876,69.1,0,0.0
VOLKSWAGEN,POLO,2002,1883,509,27.0,1374,73.0,1,0.1
VOLKSWAGEN,POLO,2003,2346,629,26.8,1717,73.2,1,0.0
VOLKSWAGEN,POLO,2004,2434,740,30.4,1694,69.6,0,0.0
VOLKSWAGEN,POLO,2005,2357,787,33.4,1570,66.6,0,0.0
VOLKSWAGEN,POLO,2006,2623,1080,41.2,1543,58.8,0,0.0
VOLKSWAGEN,POLO,2007,2374,1071,45.1,1303,54.9,0,0.0
VOLKSWAGEN,POLO,2008,1228,594,48.4,634,51.6,1,0.1
VOLKSWAGEN,POLO,2009,487,247,50.7,240,49.3,1,0.2
VOLKSWAGEN,POLO,2010,2356,1577,66.9,779,33.1,0,0.0
VOLKSWAGEN,POLO,2011,476,282,59.2,194,40.8,1,0.2
VOLKSWAGEN,POLO,2012,1581,1177,74.4,404,25.6,0,0.0
VOLKSWAGEN,POLO,2013,294,214,72.8,80,27.2,0,0.0
VOLKSWAGEN,POLO,2014,1719,1446,84.1,273,15.9,0,0.0
VOLKSWAGEN,POLO,2015,170,152,89.4,18,10.6,0,0.0
VOLKSWAGEN,POLO,2016,2,2,100.0,0,0.0,0,0.0
VOLKSWAGEN,SCIROCCO,1983,2,1,50.0,1,50.0,0,0.0
VOLKSWAGEN,SCIROCCO,1984,2,0,0.0,2,100.0,0,0.0
VOLKSWAGEN,SCIROCCO,1985,3,1,33.3,2,66.7,0,0.0
VOLKSWAGEN,SCIROCCO,1986,2,0,0.0,2,100.0,0,0.0
VOLKSWAGEN,SCIROCCO,1987,2,0,0.0,2,100.0,0,0.0
VOLKSWAGEN,SCIROCCO,1988,1,0,0.0,1,100.0,0,0.0
VOLKSWAGEN,SCIROCCO,1989,5,2,40.0,3,60.0,0,0.0
VOLKSWAGEN,SCIROCCO,1990,3,0,0.0,3,100.0,0,0.0
VOLKSWAGEN,SCIROCCO,1992,2,0,0.0,2,100.0,0,0.0
VOLKSWAGEN,SCIROCCO,1993,1,1,100.0,0,0.0,0,0.0
VOLKSWAGEN,SCIROCCO,2008,6,4,66.7,2,33.3,0,0.0
VOLKSWAGEN,SCIROCCO,2009,141,87,61.7,54,38.3,0,0.0
VOLKSWAGEN,SCIROCCO,2010,341,230,67.4,111,32.6,0,0.0
VOLKSWAGEN,SCIROCCO,2011,84,56,66.7,28,33.3,0,0.0
VOLKSWAGEN,SCIROCCO,2012,172,130,75.6,42,24.4,0,0.0
VOLKSWAGEN,SCIROCCO,2013,40,31,77.5,9,22.5,0,0.0
VOLKSWAGEN,SCIROCCO,2014,139,113,81.3,26,18.7,0,0.0
VOLKSWAGEN,SCIROCCO,2015,14,12,85.7,2,14.3,0,0.0
VOLKSWAGEN,SHARAN,1998,5,1,20.0,4,80.0,0,0.0
VOLKSWAGEN,SHARAN,1999,4,1,25.0,3,75.0,0,0.0
VOLKSWAGEN,SHARAN,2000,8,1,12.5,7,87.5,0,0.0
VOLKSWAGEN,SHARAN,2001,30,6,20.0,24,80.0,0,0.0
VOLKSWAGEN,SHARAN,2002,42,14,33.3,28,66.7,0,0.0
VOLKSWAGEN,SHARAN,2003,88,19,21.6,69,78.4,0,0.0
VOLKSWAGEN,SHARAN,2004,147,22,15.0,125,85.0,0,0.0
VOLKSWAGEN,SHARAN,2005,229,52,22.7,177,77.3,0,0.0
VOLKSWAGEN,SHARAN,2006,225,52,23.1,173,76.9,1,0.4
VOLKSWAGEN,SHARAN,2007,215,58,27.0,157,73.0,0,0.0
VOLKSWAGEN,SHARAN,2008,120,47,39.2,73,60.8,0,0.0
VOLKSWAGEN,SHARAN,2009,23,7,30.4,16,69.6,0,0.0
VOLKSWAGEN,SHARAN,2010,42,18,42.9,24,57.1,0,0.0
VOLKSWAGEN,SHARAN,2011,25,14,56.0,11,44.0,0,0.0
VOLKSWAGEN,SHARAN,2012,97,74,76.3,23,23.7,0,0.0
VOLKSWAGEN,SHARAN,2013,18,11,61.1,7,38.9,0,0.0
VOLKSWAGEN,SHARAN,2014,53,42,79.2,11,20.8,0,0.0
VOLKSWAGEN,SHARAN,2015,2,2,100.0,0,0.0,0,0.0
VOLKSWAGEN,SHARAN,2016,1,1,100.0,0,0.0,0,0.0
VOLKSWAGEN,SHUTTLE,2004,1,0,0.0,1,100.0,0,0.0
VOLKSWAGEN,SHUTTLE,2005,21,6,28.6,15,71.4,0,0.0
VOLKSWAGEN,SHUTTLE,2006,20,8,40.0,12,60.0,0,0.0
VOLKSWAGEN,SHUTTLE,2007,213,87,40.8,126,59.2,0,0.0
VOLKSWAGEN,SHUTTLE,2008,109,46,42.2,63,57.8,0,0.0
VOLKSWAGEN,SHUTTLE,2009,23,7,30.4,16,69.6,0,0.0
VOLKSWAGEN,SHUTTLE,2010,48,24,50.0,24,50.0,0,0.0
VOLKSWAGEN,SHUTTLE,2011,29,16,55.2,13,44.8,0,0.0
VOLKSWAGEN,SHUTTLE,2012,51,34,66.7,17,33.3,0,0.0
VOLKSWAGEN,SHUTTLE,2013,9,6,66.7,3,33.3,0,0.0
VOLKSWAGEN,SHUTTLE,2014,29,19,65.5,10,34.5,1,3.4
VOLKSWAGEN,SHUTTLE,2015,26,21,80.8,5,19.2,0,0.0
VOLKSWAGEN,SHUTTLE,2016,4,3,75.0,1,25.0,0,0.0
VOLKSWAGEN,TIGUAN,2008,179,103,57.5,76,42.5,0,0.0
VOLKSWAGEN,TIGUAN,2009,58,25,43.1,33,56.9,0,0.0
VOLKSWAGEN,TIGUAN,2010,271,188,69.4,83,30.6,0,0.0
VOLKSWAGEN,TIGUAN,2011,66,47,71.2,19,28.8,1,1.5
VOLKSWAGEN,TIGUAN,2012,570,452,79.3,118,20.7,0,0.0
VOLKSWAGEN,TIGUAN,2013,89,78,87.6,11,12.4,0,0.0
VOLKSWAGEN,TIGUAN,2014,1002,842,84.0,160,16.0,1,0.1
VOLKSWAGEN,TIGUAN,2015,129,116,89.9,13,10.1,0,0.0
VOLKSWAGEN,TIGUAN,2016,1,1,100.0,0,0.0,0,0.0
VOLKSWAGEN,TOUAREG,2003,5,1,20.0,4,80.0,0,0.0
VOLKSWAGEN,TOUAREG,2004,101,34,33.7,67,66.3,0,0.0
VOLKSWAGEN,TOUAREG,2005,191,65,34.0,126,66.0,0,0.0
VOLKSWAGEN,TOUAREG,2006,169,65,38.5,104,61.5,0,0.0
VOLKSWAGEN,TOUAREG,2007,155,73,47.1,82,52.9,2,1.3
VOLKSWAGEN,TOUAREG,2008,54,23,42.6,31,57.4,0,0.0
VOLKSWAGEN,TOUAREG,2009,2,0,0.0,2,100.0,0,0.0
VOLKSWAGEN,TOUAREG,2010,3,3,100.0,0,0.0,0,0.0
VOLKSWAGEN,TOUAREG,2011,5,4,80.0,1,20.0,0,0.0
VOLKSWAGEN,TOUAREG,2012,33,26,78.8,7,21.2,1,3.0
VOLKSWAGEN,TOUAREG,2013,7,4,57.1,3,42.9,0,0.0
VOLKSWAGEN,TOUAREG,2014,18,14,77.8,4,22.2,0,0.0
VOLKSWAGEN,TOUAREG,2015,3,2,66.7,1,33.3,0,0.0
VOLKSWAGEN,TOUAREG,2017,1,1,100.0,0,0.0,0,0.0
VOLKSWAGEN,TOUAREG ALTITUDE,2006,1,1,100.0,0,0.0,0,0.0
VOLKSWAGEN,TOURAN,2000,2,0,0.0,2,100.0,0,0.0
VOLKSWAGEN,TOURAN,2003,50,14,28.0,36,72.0,0,0.0
VOLKSWAGEN,TOURAN,2004,309,84,27.2,225,72.8,0,0.0
VOLKSWAGEN,TOURAN,2005,371,130,35.0,241,65.0,1,0.3
VOLKSWAGEN,TOURAN,2006,355,109,30.7,246,69.3,0,0.0
VOLKSWAGEN,TOURAN,2007,458,199,43.4,259,56.6,0,0.0
VOLKSWAGEN,TOURAN,2008,341,146,42.8,195,57.2,0,0.0
VOLKSWAGEN,TOURAN,2009,93,42,45.2,51,54.8,0,0.0
VOLKSWAGEN,TOURAN,2010,243,143,58.8,100,41.2,0,0.0
VOLKSWAGEN,TOURAN,2011,108,69,63.9,39,36.1,0,0.0
VOLKSWAGEN,TOURAN,2012,282,211,74.8,71,25.2,1,0.4
VOLKSWAGEN,TOURAN,2013,53,41,77.4,12,22.6,0,0.0
VOLKSWAGEN,TOURAN,2014,258,208,80.6,50,19.4,0,0.0
VOLKSWAGEN,TOURAN,2015,12,11,91.7,1,8.3,0,0.0
VOLKSWAGEN,TOURAN,2016,3,1,33.3,2,66.7,0,0.0
VOLKSWAGEN,TRANSPORTER,1972,1,1,100.0,0,0.0,0,0.0
VOLKSWAGEN,TRANSPORTER,1984,1,0,0.0,1,100.0,0,0.0
VOLKSWAGEN,TRANSPORTER,1987,1,0,0.0,1,100.0,0,0.0
VOLKSWAGEN,TRANSPORTER,1988,1,0,0.0,1,100.0,0,0.0
VOLKSWAGEN,TRANSPORTER,1999,1,0,0.0,1,100.0,0,0.0
VOLKSWAGEN,TRANSPORTER,2000,1,1,100.0,0,0.0,0,0.0
VOLKSWAGEN,TRANSPORTER,2001,1,0,0.0,1,100.0,0,0.0
VOLKSWAGEN,TRANSPORTER,2003,1,1,100.0,0,0.0,0,0.0
VOLKSWAGEN,TRANSPORTER,2004,9,2,22.2,7,77.8,0,0.0
VOLKSWAGEN,TRANSPORTER,2005,27,8,29.6,19,70.4,0,0.0
VOLKSWAGEN,TRANSPORTER,2006,20,8,40.0,12,60.0,0,0.0
VOLKSWAGEN,TRANSPORTER,2007,10,4,40.0,6,60.0,0,0.0
VOLKSWAGEN,TRANSPORTER,2008,12,6,50.0,6,50.0,0,0.0
VOLKSWAGEN,TRANSPORTER,2009,4,2,50.0,2,50.0,0,0.0
VOLKSWAGEN,TRANSPORTER,2010,8,7,87.5,1,12.5,0,0.0
VOLKSWAGEN,TRANSPORTER,2011,3,3,100.0,0,0.0,0,0.0
VOLKSWAGEN,TRANSPORTER,2012,2,2,100.0,0,0.0,0,0.0
VOLKSWAGEN,TRANSPORTER,2013,3,3,100.0,0,0.0,0,0.0
VOLKSWAGEN,TRANSPORTER,2014,4,2,50.0,2,50.0,1,25.0
VOLKSWAGEN,TRANSPORTER,2015,2,2,100.0,0,0.0,0,0.0
VOLKSWAGEN,TRANSPORTER,2016,16,11,68.8,5,31.3,0,0.0
VOLKSWAGEN,TRANSPORTER,2017,1,1,100.0,0,0.0,0,0.0
VOLKSWAGEN,UP,2012,262,205,78.2,57,21.8,0,0.0
VOLKSWAGEN,UP,2013,57,44,77.2,13,22.8,0,0.0
VOLKSWAGEN,UP,2014,318,259,81.4,59,18.6,0,0.0
VOLKSWAGEN,UP,2015,26,21,80.8,5,19.2,0,0.0
VOLKSWAGEN,VAN,2010,2,1,50.0,1,50.0,0,0.0
VOLKSWAGEN,VENTO,1992,4,0,0.0,4,100.0,0,0.0
VOLKSWAGEN,VENTO,1993,5,3,60.0,2,40.0,0,0.0
VOLKSWAGEN,VENTO,1994,8,1,12.5,7,87.5,0,0.0
VOLKSWAGEN,VENTO,1995,23,2,8.7,21,91.3,0,0.0
VOLKSWAGEN,VENTO,1996,33,13,39.4,20,60.6,0,0.0
VOLKSWAGEN,VENTO,1997,43,13,30.2,30,69.8,0,0.0
VOLKSWAGEN,VENTO,1998,5,1,20.0,4,80.0,0,0.0
VOLVO,240,1985,3,0,0.0,3,100.0,0,0.0
VOLVO,240,1986,2,0,0.0,2,100.0,0,0.0
VOLVO,240,1987,1,1,100.0,0,0.0,0,0.0
VOLVO,240,1988,5,3,60.0,2,40.0,0,0.0
VOLVO,240,1989,2,0,0.0,2,100.0,0,0.0
VOLVO,240,1990,4,1,25.0,3,75.0,0,0.0
VOLVO,240,1991,2,1,50.0,1,50.0,0,0.0
VOLVO,240,1992,2,1,50.0,1,50.0,0,0.0
VOLVO,240,1993,4,3,75.0,1,25.0,0,0.0
VOLVO,244,1980,1,1,100.0,0,0.0,0,0.0
VOLVO,340,1987,1,0,0.0,1,100.0,0,0.0
VOLVO,340,1989,1,0,0.0,1,100.0,0,0.0
VOLVO,343,1980,1,0,0.0,1,100.0,0,0.0
VOLVO,40 SERIES,1997,3,0,0.0,3,100.0,0,0.0
VOLVO,40 SERIES,1998,10,2,20.0,8,80.0,0,0.0
VOLVO,40 SERIES,1999,21,9,42.9,12,57.1,0,0.0
VOLVO,40 SERIES,2000,19,8,42.1,11,57.9,0,0.0
VOLVO,40 SERIES,2001,23,7,30.4,16,69.6,0,0.0
VOLVO,40 SERIES,2002,53,10,18.9,43,81.1,0,0.0
VOLVO,40 SERIES,2003,119,34,28.6,85,71.4,0,0.0
VOLVO,40 SERIES,2004,165,49,29.7,116,70.3,1,0.6
VOLVO,40 SERIES,2005,170,68,40.0,102,60.0,0,0.0
VOLVO,40 SERIES,2006,150,58,38.7,92,61.3,1,0.7
VOLVO,40 SERIES,2007,105,41,39.0,64,61.0,0,0.0
VOLVO,40 SERIES,2008,288,109,37.8,179,62.2,0,0.0
VOLVO,40 SERIES,2009,86,38,44.2,48,55.8,0,0.0
VOLVO,40 SERIES,2010,65,41,63.1,24,36.9,0,0.0
VOLVO,40 SERIES,2012,27,19,70.4,8,29.6,0,0.0
VOLVO,40 SERIES,2013,125,93,74.4,32,25.6,0,0.0
VOLVO,40 SERIES,2014,428,322,75.2,106,24.8,0,0.0
VOLVO,40 SERIES,2015,17,12,70.6,5,29.4,0,0.0
VOLVO,400 SERIES,1990,2,1,50.0,1,50.0,0,0.0
VOLVO,400 SERIES,1991,1,0,0.0,1,100.0,0,0.0
VOLVO,400 SERIES,1992,1,1,100.0,0,0.0,0,0.0
VOLVO,400 SERIES,1993,2,1,50.0,1,50.0,0,0.0
VOLVO,400 SERIES,1994,5,1,20.0,4,80.0,0,0.0
VOLVO,400 SERIES,1995,6,4,66.7,2,33.3,0,0.0
VOLVO,400 SERIES,1996,5,3,60.0,2,40.0,0,0.0
VOLVO,400 SERIES,1997,3,3,100.0,0,0.0,0,0.0
VOLVO,70 SERIES,1997,3,0,0.0,3,100.0,0,0.0
VOLVO,70 SERIES,1998,17,11,64.7,6,35.3,0,0.0
VOLVO,70 SERIES,1999,4,3,75.0,1,25.0,0,0.0
VOLVO,70 SERIES,2000,15,5,33.3,10,66.7,0,0.0
VOLVO,70 SERIES,2001,9,4,44.4,5,55.6,0,0.0
VOLVO,70 SERIES,2002,9,4,44.4,5,55.6,0,0.0
VOLVO,70 SERIES,2003,6,4,66.7,2,33.3,0,0.0
VOLVO,70 SERIES,2004,4,4,100.0,0,0.0,0,0.0
VOLVO,70 SERIES,2005,6,0,0.0,6,100.0,0,0.0
VOLVO,70 SERIES,2007,1,1,100.0,0,0.0,0,0.0
VOLVO,740,1986,2,0,0.0,2,100.0,0,0.0
VOLVO,740,1987,3,0,0.0,3,100.0,0,0.0
VOLVO,740,1988,4,3,75.0,1,25.0,0,0.0
VOLVO,740,1989,2,1,50.0,1,50.0,0,0.0
VOLVO,740,1990,5,1,20.0,4,80.0,0,0.0
VOLVO,744,1991,1,1,100.0,0,0.0,0,0.0
VOLVO,745,1989,1,0,0.0,1,100.0,0,0.0
VOLVO,745,1990,3,2,66.7,1,33.3,0,0.0
VOLVO,760,1982,1,0,0.0,1,100.0,0,0.0
VOLVO,760,1984,1,1,100.0,0,0.0,0,0.0
VOLVO,760,1986,3,2,66.7,1,33.3,0,0.0
VOLVO,760,1987,1,0,0.0,1,100.0,0,0.0
VOLVO,760,1988,5,2,40.0,3,60.0,0,0.0
VOLVO,760,1989,1,1,100.0,0,0.0,0,0.0
VOLVO,760,1990,1,0,0.0,1,100.0,0,0.0
VOLVO,80 SERIES,2000,1,1,100.0,0,0.0,0,0.0
VOLVO,80 SERIES,2001,2,0,0.0,2,100.0,0,0.0
VOLVO,80 SERIES,2002,9,5,55.6,4,44.4,0,0.0
VOLVO,80 SERIES,2003,9,2,22.2,7,77.8,0,0.0
VOLVO,80 SERIES,2004,18,5,27.8,13,72.2,0,0.0
VOLVO,80 SERIES,2005,13,4,30.8,9,69.2,0,0.0
VOLVO,80 SERIES,2006,22,8,36.4,14,63.6,0,0.0
VOLVO,80 SERIES,2007,15,9,60.0,6,40.0,0,0.0
VOLVO,80 SERIES,2008,23,10,43.5,13,56.5,0,0.0
VOLVO,80 SERIES,2009,32,14,43.8,18,56.3,0,0.0
VOLVO,80 SERIES,2010,49,29,59.2,20,40.8,0,0.0
VOLVO,80 SERIES,2011,15,7,46.7,8,53.3,0,0.0
VOLVO,80 SERIES,2012,41,30,73.2,11,26.8,0,0.0
VOLVO,80 SERIES,2013,12,10,83.3,2,16.7,0,0.0
VOLVO,80 SERIES,2014,15,12,80.0,3,20.0,0,0.0
VOLVO,800 SERIES,1994,7,4,57.1,3,42.9,0,0.0
VOLVO,800 SERIES,1995,8,2,25.0,6,75.0,0,0.0
VOLVO,800 SERIES,1996,24,10,41.7,14,58.3,0,0.0
VOLVO,800 SERIES,1997,16,6,37.5,10,62.5,0,0.0
VOLVO,90 SERIES,1998,1,0,0.0,1,100.0,0,0.0
VOLVO,90 SERIES,2003,37,8,21.6,29,78.4,0,0.0
VOLVO,90 SERIES,2004,257,68,26.5,189,73.5,2,0.8
VOLVO,90 SERIES,2005,224,53,23.7,171,76.3,0,0.0
VOLVO,90 SERIES,2006,81,26,32.1,55,67.9,0,0.0
VOLVO,90 SERIES,2007,81,32,39.5,49,60.5,0,0.0
VOLVO,90 SERIES,2008,31,13,41.9,18,58.1,0,0.0
VOLVO,90 SERIES,2009,29,13,44.8,16,55.2,0,0.0
VOLVO,90 SERIES,2010,161,63,39.1,98,60.9,0,0.0
VOLVO,90 SERIES,2011,15,7,46.7,8,53.3,0,0.0
VOLVO,90 SERIES,2012,21,10,47.6,11,52.4,0,0.0
VOLVO,90 SERIES,2013,5,4,80.0,1,20.0,0,0.0
VOLVO,90 SERIES,2014,13,11,84.6,2,15.4,0,0.0
VOLVO,900 SERIES,1990,1,0,0.0,1,100.0,0,0.0
VOLVO,900 SERIES,1993,4,1,25.0,3,75.0,0,0.0
VOLVO,900 SERIES,1994,6,1,16.7,5,83.3,0,0.0
VOLVO,900 SERIES,1995,3,2,66.7,1,33.3,0,0.0
VOLVO,900 SERIES,1996,8,5,62.5,3,37.5,0,0.0
VOLVO,900 SERIES,1997,8,5,62.5,3,37.5,0,0.0
VOLVO,900 SERIES,1998,2,1,50.0,1,50.0,0,0.0
VOLVO,900 SERIES,2000,1,0,0.0,1,100.0,0,0.0
VOLVO,C30,2006,3,2,66.7,1,33.3,0,0.0
VOLVO,C30,2007,191,97,50.8,94,49.2,0,0.0
VOLVO,C30,2008,132,74,56.1,58,43.9,0,0.0
VOLVO,C30,2009,70,40,57.1,30,42.9,0,0.0
VOLVO,C30,2010,121,78,64.5,43,35.5,0,0.0
VOLVO,C30,2011,24,17,70.8,7,29.2,0,0.0
VOLVO,C30,2012,34,20,58.8,14,41.2,0,0.0
VOLVO,C30,2013,7,1,14.3,6,85.7,0,0.0
VOLVO,C30,2014,1,1,100.0,0,0.0,0,0.0
VOLVO,C70,1998,1,1,100.0,0,0.0,0,0.0
VOLVO,C70,2000,2,1,50.0,1,50.0,0,0.0
VOLVO,C70,2001,6,1,16.7,5,83.3,0,0.0
VOLVO,C70,2002,1,0,0.0,1,100.0,0,0.0
VOLVO,C70,2003,3,2,66.7,1,33.3,0,0.0
VOLVO,C70,2004,6,3,50.0,3,50.0,0,0.0
VOLVO,C70,2005,5,4,80.0,1,20.0,0,0.0
VOLVO,C70,2006,44,17,38.6,27,61.4,0,0.0
VOLVO,C70,2007,51,20,39.2,31,60.8,0,0.0
VOLVO,C70,2008,17,10,58.8,7,41.2,0,0.0
VOLVO,C70,2010,4,4,100.0,0,0.0,0,0.0
VOLVO,C70,2011,1,1,100.0,0,0.0,0,0.0
VOLVO,C70,2012,1,1,100.0,0,0.0,0,0.0
VOLVO,C70 2.0 LPT 2DR,2003,1,0,0.0,1,100.0,0,0.0
VOLVO,FL6,2014,26,19,73.1,7,26.9,0,0.0
VOLVO,OTHER,1981,1,0,0.0,1,100.0,0,0.0
VOLVO,OTHER,1982,1,1,100.0,0,0.0,0,0.0
VOLVO,OTHER,1983,3,2,66.7,1,33.3,0,0.0
VOLVO,OTHER,1987,1,0,0.0,1,100.0,0,0.0
VOLVO,OTHER,1989,1,1,100.0,0,0.0,0,0.0
VOLVO,OTHER,1990,2,0,0.0,2,100.0,0,0.0
VOLVO,OTHER,1991,3,2,66.7,1,33.3,0,0.0
VOLVO,OTHER,1992,6,2,33.3,4,66.7,0,0.0
VOLVO,OTHER,1993,2,0,0.0,2,100.0,0,0.0
VOLVO,OTHER,1994,2,2,100.0,0,0.0,0,0.0
VOLVO,OTHER,1995,2,0,0.0,2,100.0,0,0.0
VOLVO,OTHER,1996,3,0,0.0,3,100.0,0,0.0
VOLVO,OTHER,1997,1,1,100.0,0,0.0,0,0.0
VOLVO,OTHER,1999,4,1,25.0,3,75.0,0,0.0
VOLVO,OTHER,2000,15,6,40.0,9,60.0,0,0.0
VOLVO,OTHER,2001,43,21,48.8,22,51.2,0,0.0
VOLVO,OTHER,2002,3,2,66.7,1,33.3,0,0.0
VOLVO,OTHER,2003,29,13,44.8,16,55.2,0,0.0
VOLVO,OTHER,2004,15,4,26.7,11,73.3,0,0.0
VOLVO,OTHER,2005,105,34,32.4,71,67.6,0,0.0
VOLVO,OTHER,2006,21,9,42.9,12,57.1,0,0.0
VOLVO,OTHER,2007,1,0,0.0,1,100.0,0,0.0
VOLVO,S40,1996,1,0,0.0,1,100.0,0,0.0
VOLVO,S40,1997,6,1,16.7,5,83.3,0,0.0
VOLVO,S40,1998,13,5,38.5,8,61.5,0,0.0
VOLVO,S40,1999,16,7,43.8,9,56.3,0,0.0
VOLVO,S40,2000,37,12,32.4,25,67.6,0,0.0
VOLVO,S40,2001,50,19,38.0,31,62.0,0,0.0
VOLVO,S40,2002,95,35,36.8,60,63.2,0,0.0
VOLVO,S40,2003,191,66,34.6,125,65.4,0,0.0
VOLVO,S40,2004,285,87,30.5,198,69.5,0,0.0
VOLVO,S40,2005,812,334,41.1,478,58.9,0,0.0
VOLVO,S40,2006,1010,429,42.5,581,57.5,1,0.1
VOLVO,S40,2007,1009,479,47.5,530,52.5,0,0.0
VOLVO,S40,2008,788,357,45.3,431,54.7,1,0.1
VOLVO,S40,2009,181,89,49.2,92,50.8,0,0.0
VOLVO,S40,2010,530,286,54.0,244,46.0,0,0.0
VOLVO,S40,2011,111,67,60.4,44,39.6,0,0.0
VOLVO,S40,2012,399,270,67.7,129,32.3,0,0.0
VOLVO,S40,2013,2,2,100.0,0,0.0,0,0.0
VOLVO,S40 2.0 SE 4DR,2004,1,0,0.0,1,100.0,0,0.0
VOLVO,S60,2000,2,0,0.0,2,100.0,0,0.0
VOLVO,S60,2001,5,1,20.0,4,80.0,0,0.0
VOLVO,S60,2002,53,18,34.0,35,66.0,0,0.0
VOLVO,S60,2003,85,36,42.4,49,57.6,1,1.2
VOLVO,S60,2004,145,51,35.2,94,64.8,0,0.0
VOLVO,S60,2005,165,67,40.6,98,59.4,0,0.0
VOLVO,S60,2006,159,69,43.4,90,56.6,0,0.0
VOLVO,S60,2007,150,57,38.0,93,62.0,1,0.7
VOLVO,S60,2008,38,23,60.5,15,39.5,0,0.0
VOLVO,S60,2010,46,30,65.2,16,34.8,0,0.0
VOLVO,S60,2011,113,70,61.9,43,38.1,0,0.0
VOLVO,S60,2012,351,228,65.0,123,35.0,0,0.0
VOLVO,S60,2013,74,54,73.0,20,27.0,0,0.0
VOLVO,S60,2014,420,349,83.1,71,16.9,0,0.0
VOLVO,S60,2015,40,33,82.5,7,17.5,0,0.0
VOLVO,S60,2016,3,2,66.7,1,33.3,0,0.0
VOLVO,S60 D5 SE 4DR A,2005,1,1,100.0,0,0.0,0,0.0
VOLVO,S60 T5 SE AUTO,2004,1,1,100.0,0,0.0,0,0.0
VOLVO,S80,1999,9,5,55.6,4,44.4,0,0.0
VOLVO,S80,2000,22,10,45.5,12,54.5,0,0.0
VOLVO,S80,2001,20,5,25.0,15,75.0,0,0.0
VOLVO,S80,2002,34,14,41.2,20,58.8,0,0.0
VOLVO,S80,2003,62,24,38.7,38,61.3,0,0.0
VOLVO,S80,2004,79,27,34.2,52,65.8,1,1.3
VOLVO,S80,2005,92,42,45.7,50,54.3,0,0.0
VOLVO,S80,2006,74,42,56.8,32,43.2,0,0.0
VOLVO,S80,2007,145,80,55.2,65,44.8,0,0.0
VOLVO,S80,2008,151,87,57.6,64,42.4,0,0.0
VOLVO,S80,2009,15,6,40.0,9,60.0,0,0.0
VOLVO,S80,2010,118,82,69.5,36,30.5,0,0.0
VOLVO,S80,2011,10,8,80.0,2,20.0,0,0.0
VOLVO,S80,2012,54,41,75.9,13,24.1,0,0.0
VOLVO,S80,2013,14,12,85.7,2,14.3,0,0.0
VOLVO,S80,2014,35,26,74.3,9,25.7,0,0.0
VOLVO,S80,2015,3,2,66.7,1,33.3,0,0.0
VOLVO,S80,2016,1,1,100.0,0,0.0,0,0.0
VOLVO,S90,2016,1,1,100.0,0,0.0,0,0.0
VOLVO,S90,2017,3,3,100.0,0,0.0,0,0.0
VOLVO,S90,2018,1,1,100.0,0,0.0,0,0.0
VOLVO,V40,2012,31,29,93.5,2,6.5,0,0.0
VOLVO,V40,2013,42,34,81.0,8,19.0,0,0.0
VOLVO,V40,2014,371,300,80.9,71,19.1,0,0.0
VOLVO,V40,2015,52,45,86.5,7,13.5,0,0.0
VOLVO,V50,2004,45,13,28.9,32,71.1,0,0.0
VOLVO,V50,2005,360,160,44.4,200,55.6,0,0.0
VOLVO,V50,2006,417,194,46.5,223,53.5,1,0.2
VOLVO,V50,2007,349,165,47.3,184,52.7,0,0.0
VOLVO,V50,2008,417,180,43.2,237,56.8,0,0.0
VOLVO,V50,2009,124,51,41.1,73,58.9,0,0.0
VOLVO,V50,2010,323,161,49.8,162,50.2,0,0.0
VOLVO,V50,2011,64,31,48.4,33,51.6,0,0.0
VOLVO,V50,2012,208,136,65.4,72,34.6,0,0.0
VOLVO,V50,2013,2,2,100.0,0,0.0,0,0.0
VOLVO,V50,2016,1,1,100.0,0,0.0,0,0.0
VOLVO,V60,2010,4,3,75.0,1,25.0,0,0.0
VOLVO,V60,2011,38,25,65.8,13,34.2,0,0.0
VOLVO,V60,2012,195,134,68.7,61,31.3,0,0.0
VOLVO,V60,2013,46,38,82.6,8,17.4,0,0.0
VOLVO,V60,2014,208,182,87.5,26,12.5,0,0.0
VOLVO,V60,2015,10,9,90.0,1,10.0,0,0.0
VOLVO,V70,1997,5,3,60.0,2,40.0,0,0.0
VOLVO,V70,1998,10,5,50.0,5,50.0,0,0.0
VOLVO,V70,1999,12,5,41.7,7,58.3,0,0.0
VOLVO,V70,2000,26,9,34.6,17,65.4,0,0.0
VOLVO,V70,2001,31,8,25.8,23,74.2,0,0.0
VOLVO,V70,2002,84,26,31.0,58,69.0,0,0.0
VOLVO,V70,2003,90,38,42.2,52,57.8,0,0.0
VOLVO,V70,2004,134,60,44.8,74,55.2,0,0.0
VOLVO,V70,2005,131,54,41.2,77,58.8,0,0.0
VOLVO,V70,2006,115,52,45.2,63,54.8,0,0.0
VOLVO,V70,2007,98,52,53.1,46,46.9,0,0.0
VOLVO,V70,2008,103,67,65.0,36,35.0,0,0.0
VOLVO,V70,2009,35,16,45.7,19,54.3,0,0.0
VOLVO,V70,2010,98,57,58.2,41,41.8,0,0.0
VOLVO,V70,2011,20,13,65.0,7,35.0,0,0.0
VOLVO,V70,2012,48,34,70.8,14,29.2,0,0.0
VOLVO,V70,2013,14,10,71.4,4,28.6,0,0.0
VOLVO,V70,2014,48,42,87.5,6,12.5,0,0.0
VOLVO,V70,2015,5,5,100.0,0,0.0,0,0.0
VOLVO,V90,2014,1,1,100.0,0,0.0,0,0.0
VOLVO,XC60,2008,7,5,71.4,2,28.6,0,0.0
VOLVO,XC60,2009,17,10,58.8,7,41.2,0,0.0
VOLVO,XC60,2010,91,52,57.1,39,42.9,0,0.0
VOLVO,XC60,2011,32,22,68.8,10,31.3,0,0.0
VOLVO,XC60,2012,115,81,70.4,34,29.6,1,0.9
VOLVO,XC60,2013,30,23,76.7,7,23.3,0,0.0
VOLVO,XC60,2014,480,395,82.3,85,17.7,1,0.2
VOLVO,XC60,2015,46,36,78.3,10,21.7,0,0.0
VOLVO,XC60,2016,1,1,100.0,0,0.0,0,0.0
VOLVO,XC70,2003,6,1,16.7,5,83.3,0,0.0
VOLVO,XC70,2004,9,2,22.2,7,77.8,0,0.0
VOLVO,XC70,2005,18,3,16.7,15,83.3,0,0.0
VOLVO,XC70,2006,39,14,35.9,25,64.1,1,2.6
VOLVO,XC70,2007,21,13,61.9,8,38.1,0,0.0
VOLVO,XC70,2008,25,15,60.0,10,40.0,0,0.0
VOLVO,XC70,2009,2,2,100.0,0,0.0,0,0.0
VOLVO,XC70,2010,5,5,100.0,0,0.0,0,0.0
VOLVO,XC70,2011,3,1,33.3,2,66.7,0,0.0
VOLVO,XC70,2012,11,9,81.8,2,18.2,0,0.0
VOLVO,XC70,2013,2,2,100.0,0,0.0,0,0.0
VOLVO,XC70,2014,11,10,90.9,1,9.1,0,0.0
VOLVO,XC70,2015,1,1,100.0,0,0.0,0,0.0
VOLVO,XC90,2005,37,13,35.1,24,64.9,0,0.0
VOLVO,XC90,2006,248,80,32.3,168,67.7,0,0.0
VOLVO,XC90,2007,254,71,28.0,183,72.0,1,0.4
VOLVO,XC90,2008,105,36,34.3,69,65.7,0,0.0
VOLVO,XC90,2009,1,0,0.0,1,100.0,0,0.0
VOLVO,XC90,2010,15,7,46.7,8,53.3,0,0.0
VOLVO,XC90,2011,10,3,30.0,7,70.0,0,0.0
VOLVO,XC90,2012,48,32,66.7,16,33.3,0,0.0
VOLVO,XC90,2013,2,0,0.0,2,100.0,0,0.0
VOLVO,XC90,2014,69,44,63.8,25,36.2,0,0.0
VOLVO,XC90,2015,3,2,66.7,1,33.3,0,0.0
VOLVO,XC90,2016,1,1,100.0,0,0.0,0,0.0
WESTFIELD,OTHER,2006,3,1,33.3,2,66.7,0,0.0
